"PokerStars Hand #232702983618: Tournament #3332579367, $9.22+$0.78 USD Hold'em No Limit - Level IX (200/400) - 2021/12/31 22:54:36 ET\r\nTable '3332579367 2' 9-max Seat #4 is the button\r\nSeat 2: TLNDink2749 (6632 in chips)\r\nSeat 4: IPray2Buddha (1745 in chips)\r\nSeat 6: Willifold777 (5477 in chips)\r\nSeat 7: Sickofitall5 (8704 in chips)\r\nSeat 9: perussatto4 (4442 in chips)\r\nTLNDink2749: posts the ante 25\r\nIPray2Buddha: posts the ante 25\r\nWillifold777: posts the ante 25\r\nSickofitall5: posts the ante 25\r\nperussatto4: posts the ante 25\r\nWillifold777: posts small blind 200\r\nSickofitall5: posts big blind 400

\r\n*** HOLE CARDS ***\r\nDealt to IPray2Buddha [Kc Kd]\r\nperussatto4: folds\r\nTLNDink2749: raises 400 to 800\r\nIPray2Buddha: raises 920 to 1720 and is all-in\r\nWillifold777: folds\r\nSickofitall5: calls 1320\r\nTLNDink2749: calls 920\r\n*** FLOP *** [3h 2s 6c]\r\nSickofitall5: checks\r\nTLNDink2749: checks\r\n*** TURN *** [3h 2s 6c] [4h]\r\nSickofitall5: bets 800\r\nTLNDink2749: calls 800\r\n*** RIVER *** [3h 2s 6c 4h] [Ts]\r\nSickofitall5: bets 1200\r\nTLNDink2749: raises 1200 to 2400\r\nSickofitall5: calls 1200\r\n*** SHOW DOWN ***\r\nTLNDink2749: shows [Th Js] (a pair of Tens)\r\nSickofitall5: shows [Ad 5d] (a straight, Deuce to Six)\r\nSickofitall5 collected 6400 from side pot\r\n\r\nSickofitall5 collected 5485 from main pot\r\nIPray2Buddha finished the tournament in 5th place\r\n*** SUMMARY ***\r\nTotal pot 11885 Main pot 5485. Side pot 6400. | Rake 0\r\nBoard [3h 2s 6c 4h Ts]\r\nSeat 2: TLNDink2749 showed [Th Js] and lost with a pair of Tens\r\nSeat 4: IPray2Buddha (button) mucked [Kc Kd]\r\nSeat 6: Willifold777 (small blind) folded before Flop\r\nSeat 7: Sickofitall5 (big blind) showed [Ad 5d] and won (11885) with a straight, Deuce to Six\r\nSeat 9: perussatto4 folded before Flop (didn't bet)\r\n\r\nPokerStars Hand #232702792607: Tournament #3332581238, $9.22+$0.78 USD Hold'em No Limit - Level V (60/120) - 2021/12/31 22:40:56 ET\r\nTable '3332581238 2' 9-max Seat #9 is the button\r\nSeat 1: Sakura2892 (763 in chips)\r\nSeat 2: chuckie247 (2313 in chips)\r\nSeat 3: w.gator900 (7553 in chips)\r\nSeat 4: Lillien66 (3300 in chips)\r\nSeat 5: papajoe179 (1291 in chips)\r\nSeat 6: x_Jaures_x (806 in chips)\r\nSeat 7: IPray2Buddha (1805 in chips)\r\nSeat 8: mpolishuk (3381 in chips)\r\nSeat 9: owlie45 (5788 in chips)\r\nSakura2892: posts the ante 15\r\nchuckie247: posts the ante 15\r\nw.gator900: posts the ante 15\r\nLillien66: posts the ante 15\r\npapajoe179: posts the ante 15\r\nx_Jaures_x: posts the ante 15\r\nIPray2Buddha: posts the ante 15\r\nmpolishuk: posts the ante 15\r\nowlie45: posts the ante 15\r\nSakura2892: posts small blind 60\r\nchuckie247: posts big blind 120

\r\n*** HOLE CARDS ***\r\nDealt to IPray2Buddha [Qd 8h]\r\nw.gator900: folds\r\nLillien66: folds\r\npapajoe179: folds\r\nx_Jaures_x: folds\r\nIPray2Buddha: folds\r\nmpolishuk: raises 120 to 240\r\nowlie45: folds\r\nSakura2892: folds\r\nchuckie247: calls 120\r\n*** FLOP *** [2d 6h 6c]\r\nchuckie247: checks\r\nmpolishuk: checks\r\n*** TURN *** [2d 6h 6c] [3c]\r\nchuckie247: bets 240\r\nmpolishuk: calls 240\r\n*** RIVER *** [2d 6h 6c 3c] [5s]\r\nchuckie247: bets 840\r\nmpolishuk: folds\r\nUncalled bet (840) returned to chuckie247\r\nchuckie247 collected 1155 from pot\r\n*** SUMMARY ***\r\nTotal pot 1155 | Rake 0\r\nBoard [2d 6h 6c 3c 5s]\r\nSeat 1: Sakura2892 (small blind) folded before Flop\r\nSeat 2: chuckie247 (big blind) collected (1155)\r\nSeat 3: w.gator900 folded before Flop (didn't bet)\r\nSeat 4: Lillien66 folded before Flop (didn't bet)\r\nSeat 5: papajoe179 folded before Flop (didn't bet)\r\nSeat 6: x_Jaures_x folded before Flop (didn't bet)\r\nSeat 7: IPray2Buddha folded before Flop (didn't bet)\r\nSeat 8: mpolishuk folded on the River\r\nSeat 9: owlie45 (button) folded before Flop (didn't bet)\r\n\r\nPokerStars Hand #232702857612: Tournament #3332579367, $9.22+$0.78 USD Hold'em No Limit - Level VII (100/200) - 2021/12/31 22:45:34 ET\r\nTable '3332579367 2' 9-max Seat #2 is the button\r\nSeat 2: TLNDink2749 (9603 in chips)\r\nSeat 3: Günex66 (1662 in chips)\r\nSeat 4: IPray2Buddha (3245 in chips)\r\nSeat 6: Willifold777 (5377 in chips)\r\nSeat 7: Sickofitall5 (3521 in chips)\r\nSeat 9: perussatto4 (3592 in chips)\r\nTLNDink2749: posts the ante 25\r\nGünex66: posts the ante 25\r\nIPray2Buddha: posts the ante 25\r\nWillifold777: posts the ante 25\r\nSickofitall5: posts the ante 25\r\nperussatto4: posts the ante 25\r\nGünex66: posts small blind 100\r\nIPray2Buddha: posts big blind 200

\r\n*** HOLE CARDS ***\r\nDealt to IPray2Buddha [3h Kh]\r\nWillifold777: folds\r\nSickofitall5: raises 300 to 500\r\nperussatto4: folds\r\nTLNDink2749: folds\r\n\r\nGünex66: folds\r\n\r\n\r\nIPray2Buddha: folds\r\nUncalled bet (300) returned to Sickofitall5\r\nSickofitall5 collected 650 from pot\r\n*** SUMMARY ***\r\nTotal pot 650 | Rake 0\r\nSeat 2: TLNDink2749 (button) folded before Flop (didn't bet)\r\nSeat 3: Günex66 (small blind) folded before Flop\r\nSeat 4: IPray2Buddha (big blind) folded before Flop\r\nSeat 6: Willifold777 folded before Flop (didn't bet)\r\nSeat 7: Sickofitall5 collected (650)\r\nSeat 9: perussatto4 folded before Flop (didn't bet)\r\n\r\nPokerStars Hand #232702729984: Tournament #3332581238, $9.22+$0.78 USD Hold'em No Limit - Level IV (40/80) - 2021/12/31 22:35:52 ET\r\nTable '3332581238 2' 9-max Seat #3 is the button\r\nSeat 1: Sakura2892 (419 in chips)\r\nSeat 2: chuckie247 (2498 in chips)\r\nSeat 3: w.gator900 (8166 in chips)\r\nSeat 4: Lillien66 (3355 in chips) out of hand (moved from another table into small blind)\r\nSeat 5: papajoe179 (1516 in chips)\r\nSeat 6: x_Jaures_x (1320 in chips)\r\nSeat 7: IPray2Buddha (2090 in chips)\r\nSeat 8: mpolishuk (1998 in chips)\r\nSeat 9: owlie45 (5638 in chips)\r\n\nSakura2892: posts the ante 10\r\nchuckie247: posts the ante 10\r\nw.gator900: posts the ante 10\r\npapajoe179: posts the ante 10\r\nx_Jaures_x: posts the ante 10\r\nIPray2Buddha: posts the ante 10\r\nmpolishuk: posts the ante 10\r\nowlie45: posts the ante 10\r\npapajoe179: posts small blind 40\r\nx_Jaures_x: posts big blind 80

\r\n*** HOLE CARDS ***\r\nDealt to IPray2Buddha [8c 5d]\r\nIPray2Buddha: folds\r\nmpolishuk: folds\r\nowlie45: folds\r\nSakura2892: raises 329 to 409 and is all-in\r\nchuckie247: folds\r\nw.gator900: folds\r\npapajoe179: folds\r\nx_Jaures_x: calls 329\r\n*** FLOP *** [4c 7d 9s]\r\n*** TURN *** [4c 7d 9s] [6d]\r\n*** RIVER *** [4c 7d 9s 6d] [8d]\r\n*** SHOW DOWN ***\r\nx_Jaures_x: shows [Ks 2s] (high card King)\r\nSakura2892: shows [Td Qd] (a flush, Queen high)\r\nSakura2892 collected 938 from pot\r\n*** SUMMARY ***\r\nTotal pot 938 | Rake 0\r\nBoard [4c 7d 9s 6d 8d]\r\nSeat 1: Sakura2892 showed [Td Qd] and won (938) with a flush, Queen high\r\nSeat 2: chuckie247 folded before Flop (didn't bet)\r\nSeat 3: w.gator900 (button) folded before Flop (didn't bet)\r\nSeat 5: papajoe179 (small blind) folded before Flop\r\nSeat 6: x_Jaures_x (big blind) showed [Ks 2s] and lost with high card King\r\nSeat 7: IPray2Buddha folded before Flop (didn't bet)\r\nSeat 8: mpolishuk folded before Flop (didn't bet)\r\nSeat 9: owlie45 folded before Flop (didn't bet)\r\n\r\nPokerStars Hand #232702773002: Tournament #3332581238, $9.22+$0.78 USD Hold'em No Limit - Level V (60/120) - 2021/12/31 22:39:17 ET\r\nTable '3332581238 2' 9-max Seat #7 is the button\r\nSeat 1: Sakura2892 (913 in chips)\r\nSeat 2: chuckie247 (2463 in chips)\r\nSeat 3: w.gator900 (7583 in chips)\r\nSeat 4: Lillien66 (3330 in chips)\r\nSeat 5: papajoe179 (1441 in chips)\r\n\r\nSeat 7: IPray2Buddha (1835 in chips)\r\nSeat 8: mpolishuk (3156 in chips)\r\nSeat 9: owlie45 (5443 in chips)\r\nSakura2892: posts the ante 15\r\nchuckie247: posts the ante 15\r\nw.gator900: posts the ante 15\r\nLillien66: posts the ante 15\r\npapajoe179: posts the ante 15\r\nx_Jaures_x: posts the ante 15\r\nIPray2Buddha: posts the ante 15\r\nmpolishuk: posts the ante 15\r\nowlie45: posts the ante 15\r\nmpolishuk: posts small blind 60\r\nowlie45: posts big blind 120

\r\n*** HOLE CARDS ***\r\nDealt to IPray2Buddha [8c Td]\r\nSakura2892: folds\r\nchuckie247: folds\r\nw.gator900: folds\r\nLillien66: folds\r\npapajoe179: folds\r\nx_Jaures_x: folds\r\nIPray2Buddha: folds\r\n\r\nmpolishuk: raises 245 to 365\r\nowlie45: folds\r\nUncalled bet (245) returned to mpolishuk\r\nmpolishuk collected 375 from pot\r\n*** SUMMARY ***\r\nTotal pot 375 | Rake 0\r\nSeat 1: Sakura2892 folded before Flop (didn't bet)\r\nSeat 2: chuckie247 folded before Flop (didn't bet)\r\nSeat 3: w.gator900 folded before Flop (didn't bet)\r\nSeat 4: Lillien66 folded before Flop (didn't bet)\r\nSeat 5: papajoe179 folded before Flop (didn't bet)\r\nSeat 6: x_Jaures_x folded before Flop (didn't bet)\r\nSeat 7: IPray2Buddha (button) folded before Flop (didn't bet)\r\nSeat 8: mpolishuk (small blind) collected (375)\r\nSeat 9: owlie45 (big blind) folded before Flop\r\n\r\n\r\nPokerStars Hand #222088763207: Tournament #3091025143, $28.78+$1.22 USD Hold'em No Limit - Level III (20/40) - 2021/01/01 8:57:50 ET\r\nTable '3091025143 1' 2-max Seat #2 is the button\r\nSeat 1: IPray2Buddha (1047 in chips) \r\nSeat 2: katarina1011 (1953 in chips) \r\nkatarina1011: posts small blind 20\r\nIPray2Buddha: posts big blind 40

\r\n*** HOLE CARDS ***\r\nDealt to IPray2Buddha [6s 4c]\r\nkatarina1011: raises 40 to 80\r\nIPray2Buddha: folds \r\nUncalled bet (40) returned to katarina1011\r\nkatarina1011 collected 80 from pot\r\nkatarina1011: doesn't show hand \r\n*** SUMMARY ***\r\nTotal pot 80 | Rake 0 \r\nSeat 1: IPray2Buddha (big blind) folded before Flop\r\nSeat 2: katarina1011 (button) (small blind) collected (80)\r\n\r\n\r\nPokerStars Hand #222089018538: Tournament #3091025143, $28.78+$1.22 USD Hold'em No Limit - Level VI (40/80) - 2021/01/01 9:08:43 ET\r\nTable '3091025143 1' 2-max Seat #1 is the button\r\nSeat 1: IPray2Buddha (1136 in chips) \r\nSeat 2: katarina1011 (1864 in chips) \r\nIPray2Buddha: posts small blind 40\r\nkatarina1011: posts big blind 80

\r\n*** HOLE CARDS ***\r\nDealt to IPray2Buddha [7c Ts]\r\nIPray2Buddha: calls 40\r\nkatarina1011: raises 1784 to 1864 and is all-in\r\nIPray2Buddha: folds \r\nUncalled bet (1784) returned to katarina1011\r\nkatarina1011 collected 160 from pot\r\nkatarina1011: doesn't show hand \r\n*** SUMMARY ***\r\nTotal pot 160 | Rake 0 \r\nSeat 1: IPray2Buddha (button) (small blind) folded before Flop\r\nSeat 2: katarina1011 (big blind) collected (160)\r\n\r\n\r\n\r\nPokerStars Hand #228114177869: Tournament #3225821185, $23.50+$1.50 USD Hold'em No Limit - Level I (10/20) - 2021/07/07 6:03:17 ET\r\nTable '3225821185 1' 3-max Seat #1 is the button\r\nSeat 1: IPray2Buddha (500 in chips)\r\nSeat 2: elquemero100 (500 in chips)\r\nSeat 3: sgctps (500 in chips)\r\nelquemero100: posts small blind 10\r\nsgctps: posts big blind 20

\r\n*** HOLE CARDS ***\r\nDealt to IPray2Buddha [Js 8d]\r\nIPray2Buddha: folds\r\nelquemero100: calls 10\r\nsgctps: checks\r\n*** FLOP *** [2d 6h 2h]\r\nelquemero100: bets 20\r\nsgctps: calls 20\r\n*** TURN *** [2d 6h 2h] [2s]\r\nelquemero100: bets 40\r\nsgctps: folds\r\nUncalled bet (40) returned to elquemero100\r\nelquemero100 collected 80 from pot\r\nelquemero100: doesn't show hand\r\n*** SUMMARY ***\r\nTotal pot 80 | Rake 0\r\nBoard [2d 6h 2h 2s]\r\nSeat 1: IPray2Buddha (button) folded before Flop (didn't bet)\r\nSeat 2: elquemero100 (small blind) collected (80)\r\nSeat 3: sgctps (big blind) folded on the Turn\r\n\r\n\r\nPokerStars Hand #228114183099: Tournament #3225821185, $23.50+$1.50 USD Hold'em No Limit - Level I (10/20) - 2021/07/07 6:03:46 ET\r\nTable '3225821185 1' 3-max Seat #2 is the button\r\nSeat 1: IPray2Buddha (500 in chips)\r\nSeat 2: elquemero100 (540 in chips)\r\nSeat 3: sgctps (460 in chips)\r\nsgctps: posts small blind 10\r\nIPray2Buddha: posts big blind 20

\r\n*** HOLE CARDS ***\r\nDealt to IPray2Buddha [2h Td]\r\nelquemero100: raises 20 to 40\r\nsgctps: folds\r\nIPray2Buddha: folds\r\nUncalled bet (20) returned to elquemero100\r\nelquemero100 collected 50 from pot\r\nelquemero100: doesn't show hand\r\n*** SUMMARY ***\r\nTotal pot 50 | Rake 0\r\nSeat 1: IPray2Buddha (big blind) folded before Flop\r\nSeat 2: elquemero100 (button) collected (50)\r\nSeat 3: sgctps (small blind) folded before Flop\r\n\r\n\r\nPokerStars Hand #228114185476: Tournament #3225821185, $23.50+$1.50 USD Hold'em No Limit - Level I (10/20) - 2021/07/07 6:03:59 ET\r\nTable '3225821185 1' 3-max Seat #3 is the button\r\nSeat 1: IPray2Buddha (480 in chips)\r\nSeat 2: elquemero100 (570 in chips)\r\nSeat 3: sgctps (450 in chips)\r\nIPray2Buddha: posts small blind 10\r\nelquemero100: posts big blind 20

\r\n*** HOLE CARDS ***\r\nDealt to IPray2Buddha [8c Ah]\r\nsgctps: raises 20 to 40\r\nIPray2Buddha: raises 70 to 110\r\nelquemero100: folds\r\nsgctps: folds\r\nUncalled bet (70) returned to IPray2Buddha\r\nIPray2Buddha collected 100 from pot\r\n*** SUMMARY ***\r\nTotal pot 100 | Rake 0\r\nSeat 1: IPray2Buddha (small blind) collected (100)\r\nSeat 2: elquemero100 (big blind) folded before Flop\r\nSeat 3: sgctps (button) folded before Flop\r\n\r\n\r\nPokerStars Hand #228114188964: Tournament #3225821185, $23.50+$1.50 USD Hold'em No Limit - Level I (10/20) - 2021/07/07 6:04:18 ET\r\nTable '3225821185 1' 3-max Seat #1 is the button\r\nSeat 1: IPray2Buddha (540 in chips)\r\nSeat 2: elquemero100 (550 in chips)\r\nSeat 3: sgctps (410 in chips)\r\nelquemero100: posts small blind 10\r\nsgctps: posts big blind 20

\r\n*** HOLE CARDS ***\r\nDealt to IPray2Buddha [4c 5d]\r\nIPray2Buddha: folds\r\nelquemero100: calls 10\r\nsgctps: checks\r\n*** FLOP *** [Qs 9d 6h]\r\nelquemero100: checks\r\nsgctps: checks\r\n*** TURN *** [Qs 9d 6h] [Tc]\r\nelquemero100: checks\r\nsgctps: bets 30\r\nelquemero100: folds\r\nUncalled bet (30) returned to sgctps\r\nsgctps collected 40 from pot\r\nsgctps: doesn't show hand\r\n*** SUMMARY ***\r\nTotal pot 40 | Rake 0\r\nBoard [Qs 9d 6h Tc]\r\nSeat 1: IPray2Buddha (button) folded before Flop (didn't bet)\r\nSeat 2: elquemero100 (small blind) folded on the Turn\r\nSeat 3: sgctps (big blind) collected (40)\r\n\r\n\r\nPokerStars Hand #228114193613: Tournament #3225821185, $23.50+$1.50 USD Hold'em No Limit - Level I (10/20) - 2021/07/07 6:04:44 ET\r\nTable '3225821185 1' 3-max Seat #2 is the button\r\nSeat 1: IPray2Buddha (540 in chips)\r\nSeat 2: elquemero100 (530 in chips)\r\nSeat 3: sgctps (430 in chips)\r\nsgctps: posts small blind 10\r\nIPray2Buddha: posts big blind 20

\r\n*** HOLE CARDS ***\r\nDealt to IPray2Buddha [2d 2h]\r\nelquemero100: raises 20 to 40\r\nsgctps: folds\r\nIPray2Buddha: raises 500 to 540 and is all-in\r\nelquemero100: folds\r\nUncalled bet (500) returned to IPray2Buddha\r\nIPray2Buddha collected 90 from pot\r\n*** SUMMARY ***\r\nTotal pot 90 | Rake 0\r\nSeat 1: IPray2Buddha (big blind) collected (90)\r\nSeat 2: elquemero100 (button) folded before Flop\r\nSeat 3: sgctps (small blind) folded before Flop\r\n\r\n\r\nPokerStars Hand #228114196734: Tournament #3225821185, $23.50+$1.50 USD Hold'em No Limit - Level I (10/20) - 2021/07/07 6:05:01 ET\r\nTable '3225821185 1' 3-max Seat #3 is the button\r\nSeat 1: IPray2Buddha (590 in chips)\r\nSeat 2: elquemero100 (490 in chips)\r\nSeat 3: sgctps (420 in chips)\r\nIPray2Buddha: posts small blind 10\r\nelquemero100: posts big blind 20

\r\n*** HOLE CARDS ***\r\nDealt to IPray2Buddha [Ts 7h]\r\nsgctps: raises 20 to 40\r\nIPray2Buddha: folds\r\nelquemero100: calls 20\r\n*** FLOP *** [Tc 6h 6d]\r\nelquemero100: checks\r\nsgctps: bets 30\r\nelquemero100: calls 30\r\n*** TURN *** [Tc 6h 6d] [Jh]\r\nelquemero100: checks\r\nsgctps: checks\r\n*** RIVER *** [Tc 6h 6d Jh] [7d]\r\nelquemero100: bets 75\r\nsgctps: folds\r\nUncalled bet (75) returned to elquemero100\r\nelquemero100 collected 150 from pot\r\nelquemero100: doesn't show hand\r\n*** SUMMARY ***\r\nTotal pot 150 | Rake 0\r\nBoard [Tc 6h 6d Jh 7d]\r\nSeat 1: IPray2Buddha (small blind) folded before Flop\r\nSeat 2: elquemero100 (big blind) collected (150)\r\nSeat 3: sgctps (button) folded on the River\r\n\r\n\r\nPokerStars Hand #228114204391: Tournament #3225821185, $23.50+$1.50 USD Hold'em No Limit - Level I (10/20) - 2021/07/07 6:05:42 ET\r\nTable '3225821185 1' 3-max Seat #1 is the button\r\nSeat 1: IPray2Buddha (580 in chips)\r\nSeat 2: elquemero100 (570 in chips)\r\nSeat 3: sgctps (350 in chips)\r\nelquemero100: posts small blind 10\r\nsgctps: posts big blind 20

\r\n*** HOLE CARDS ***\r\nDealt to IPray2Buddha [Ah 6c]\r\nIPray2Buddha: raises 20 to 40\r\nelquemero100: folds\r\nsgctps: folds\r\nUncalled bet (20) returned to IPray2Buddha\r\nIPray2Buddha collected 50 from pot\r\n*** SUMMARY ***\r\nTotal pot 50 | Rake 0\r\nSeat 1: IPray2Buddha (button) collected (50)\r\nSeat 2: elquemero100 (small blind) folded before Flop\r\nSeat 3: sgctps (big blind) folded before Flop\r\n\r\n\r\nPokerStars Hand #228114205744: Tournament #3225821185, $23.50+$1.50 USD Hold'em No Limit - Level I (10/20) - 2021/07/07 6:05:50 ET\r\nTable '3225821185 1' 3-max Seat #2 is the button\r\nSeat 1: IPray2Buddha (610 in chips)\r\nSeat 2: elquemero100 (560 in chips)\r\nSeat 3: sgctps (330 in chips)\r\nsgctps: posts small blind 10\r\nIPray2Buddha: posts big blind 20

\r\n*** HOLE CARDS ***\r\nDealt to IPray2Buddha [8d Jh]\r\nelquemero100: raises 40 to 60\r\nsgctps: folds\r\nIPray2Buddha: folds\r\nUncalled bet (40) returned to elquemero100\r\nelquemero100 collected 50 from pot\r\nelquemero100: doesn't show hand\r\n*** SUMMARY ***\r\nTotal pot 50 | Rake 0\r\nSeat 1: IPray2Buddha (big blind) folded before Flop\r\nSeat 2: elquemero100 (button) collected (50)\r\nSeat 3: sgctps (small blind) folded before Flop\r\n\r\n\r\nPokerStars Hand #228114208567: Tournament #3225821185, $23.50+$1.50 USD Hold'em No Limit - Level I (10/20) - 2021/07/07 6:06:05 ET\r\nTable '3225821185 1' 3-max Seat #3 is the button\r\nSeat 1: IPray2Buddha (590 in chips)\r\nSeat 2: elquemero100 (590 in chips)\r\nSeat 3: sgctps (320 in chips)\r\nIPray2Buddha: posts small blind 10\r\nelquemero100: posts big blind 20

\r\n*** HOLE CARDS ***\r\nDealt to IPray2Buddha [2h 7c]\r\nsgctps: raises 300 to 320 and is all-in\r\nIPray2Buddha: folds\r\nelquemero100: folds\r\nUncalled bet (300) returned to sgctps\r\nsgctps collected 50 from pot\r\nsgctps: doesn't show hand\r\n*** SUMMARY ***\r\nTotal pot 50 | Rake 0\r\nSeat 1: IPray2Buddha (small blind) folded before Flop\r\nSeat 2: elquemero100 (big blind) folded before Flop\r\nSeat 3: sgctps (button) collected (50)\r\n\r\n\r\nPokerStars Hand #228114210664: Tournament #3225821185, $23.50+$1.50 USD Hold'em No Limit - Level I (10/20) - 2021/07/07 6:06:17 ET\r\nTable '3225821185 1' 3-max Seat #1 is the button\r\nSeat 1: IPray2Buddha (580 in chips)\r\nSeat 2: elquemero100 (570 in chips)\r\nSeat 3: sgctps (350 in chips)\r\nelquemero100: posts small blind 10\r\nsgctps: posts big blind 20

\r\n*** HOLE CARDS ***\r\nDealt to IPray2Buddha [6h 4c]\r\nIPray2Buddha: folds\r\nelquemero100: folds\r\nUncalled bet (10) returned to sgctps\r\nsgctps collected 20 from pot\r\nsgctps: doesn't show hand\r\n*** SUMMARY ***\r\nTotal pot 20 | Rake 0\r\nSeat 1: IPray2Buddha (button) folded before Flop (didn't bet)\r\nSeat 2: elquemero100 (small blind) folded before Flop\r\nSeat 3: sgctps (big blind) collected (20)\r\n\r\n\r\nPokerStars Hand #228114212693: Tournament #3225821185, $23.50+$1.50 USD Hold'em No Limit - Level II (15/30) - 2021/07/07 6:06:28 ET\r\nTable '3225821185 1' 3-max Seat #2 is the button\r\nSeat 1: IPray2Buddha (580 in chips)\r\nSeat 2: elquemero100 (560 in chips)\r\nSeat 3: sgctps (360 in chips)\r\nsgctps: posts small blind 15\r\nIPray2Buddha: posts big blind 30

\r\n*** HOLE CARDS ***\r\nDealt to IPray2Buddha [Jd 2h]\r\nelquemero100: raises 30 to 60\r\nsgctps: raises 300 to 360 and is all-in\r\nIPray2Buddha: folds\r\nelquemero100: calls 300\r\n*** FLOP *** [2d 6s 7s]\r\n*** TURN *** [2d 6s 7s] [3s]\r\n*** RIVER *** [2d 6s 7s 3s] [8s]\r\n*** SHOW DOWN ***\r\nsgctps: shows [Th Td] (a pair of Tens)\r\nelquemero100: shows [5s 5h] (a flush, Eight high)\r\nelquemero100 collected 750 from pot\r\nsgctps finished the tournament in 3rd place\r\n*** SUMMARY ***\r\nTotal pot 750 | Rake 0\r\nBoard [2d 6s 7s 3s 8s]\r\nSeat 1: IPray2Buddha (big blind) folded before Flop\r\nSeat 2: elquemero100 (button) showed [5s 5h] and won (750) with a flush, Eight high\r\nSeat 3: sgctps (small blind) showed [Th Td] and lost with a pair of Tens\r\n\r\n\r\nPokerStars Hand #228114217374: Tournament #3225821185, $23.50+$1.50 USD Hold'em No Limit - Level II (15/30) - 2021/07/07 6:06:53 ET\r\nTable '3225821185 1' 3-max Seat #1 is the button\r\nSeat 1: IPray2Buddha (550 in chips)\r\nSeat 2: elquemero100 (950 in chips)\r\nIPray2Buddha: posts small blind 15\r\nelquemero100: posts big blind 30

\r\n*** HOLE CARDS ***\r\nDealt to IPray2Buddha [8c Kh]\r\nIPray2Buddha: raises 30 to 60\r\nelquemero100: folds\r\nUncalled bet (30) returned to IPray2Buddha\r\nIPray2Buddha collected 60 from pot\r\n*** SUMMARY ***\r\nTotal pot 60 | Rake 0\r\nSeat 1: IPray2Buddha (button) (small blind) collected (60)\r\nSeat 2: elquemero100 (big blind) folded before Flop\r\n\r\n\r\nPokerStars Hand #228114218952: Tournament #3225821185, $23.50+$1.50 USD Hold'em No Limit - Level II (15/30) - 2021/07/07 6:07:01 ET\r\nTable '3225821185 1' 3-max Seat #2 is the button\r\nSeat 1: IPray2Buddha (580 in chips)\r\nSeat 2: elquemero100 (920 in chips)\r\nelquemero100: posts small blind 15\r\nIPray2Buddha: posts big blind 30

\r\n*** HOLE CARDS ***\r\nDealt to IPray2Buddha [6d 6c]\r\nelquemero100: raises 30 to 60\r\nIPray2Buddha: raises 520 to 580 and is all-in\r\nelquemero100: folds\r\nUncalled bet (520) returned to IPray2Buddha\r\nIPray2Buddha collected 120 from pot\r\n*** SUMMARY ***\r\nTotal pot 120 | Rake 0\r\nSeat 1: IPray2Buddha (big blind) collected (120)\r\nSeat 2: elquemero100 (button) (small blind) folded before Flop\r\n\r\n\r\nPokerStars Hand #228114154399: Tournament #3225820203, $23.50+$1.50 USD Hold'em No Limit - Level I (10/20) - 2021/07/07 6:01:04 ET\r\nTable '3225820203 1' 3-max Seat #1 is the button\r\nSeat 1: lll_HWDP_lll (500 in chips)\r\nSeat 2: misterTOPPP (500 in chips)\r\nSeat 3: IPray2Buddha (500 in chips)\r\nmisterTOPPP: posts small blind 10\r\nIPray2Buddha: posts big blind 20

\r\n*** HOLE CARDS ***\r\nDealt to IPray2Buddha [9d 3s]\r\nlll_HWDP_lll: raises 20 to 40\r\nmisterTOPPP: folds\r\nIPray2Buddha: folds\r\nUncalled bet (20) returned to lll_HWDP_lll\r\nlll_HWDP_lll collected 50 from pot\r\nlll_HWDP_lll: doesn't show hand\r\n*** SUMMARY ***\r\nTotal pot 50 | Rake 0\r\nSeat 1: lll_HWDP_lll (button) collected (50)\r\nSeat 2: misterTOPPP (small blind) folded before Flop\r\nSeat 3: IPray2Buddha (big blind) folded before Flop\r\n\r\n\r\nPokerStars Hand #228114155881: Tournament #3225820203, $23.50+$1.50 USD Hold'em No Limit - Level I (10/20) - 2021/07/07 6:01:13 ET\r\nTable '3225820203 1' 3-max Seat #2 is the button\r\nSeat 1: lll_HWDP_lll (530 in chips)\r\nSeat 2: misterTOPPP (490 in chips)\r\nSeat 3: IPray2Buddha (480 in chips)\r\nIPray2Buddha: posts small blind 10\r\nlll_HWDP_lll: posts big blind 20

\r\n*** HOLE CARDS ***\r\nDealt to IPray2Buddha [6s 6c]\r\nmisterTOPPP: folds\r\nIPray2Buddha: calls 10\r\nlll_HWDP_lll: checks\r\n*** FLOP *** [7d Jc Tc]\r\nIPray2Buddha: checks\r\nlll_HWDP_lll: checks\r\n*** TURN *** [7d Jc Tc] [Kh]\r\nIPray2Buddha: bets 40\r\nlll_HWDP_lll: folds\r\nUncalled bet (40) returned to IPray2Buddha\r\nIPray2Buddha collected 40 from pot\r\n*** SUMMARY ***\r\nTotal pot 40 | Rake 0\r\nBoard [7d Jc Tc Kh]\r\nSeat 1: lll_HWDP_lll (big blind) folded on the Turn\r\nSeat 2: misterTOPPP (button) folded before Flop (didn't bet)\r\nSeat 3: IPray2Buddha (small blind) collected (40)\r\n\r\nHand #12: \r\n\r\nPokerStars Hand #222088744614: Tournament #3091025143, $28.78+$1.22 USD Hold'em No Limit - Level II (15/30) - 2021/01/01 8:56:53 ET\r\nTable '3091025143 1' 2-max Seat #2 is the button\r\nSeat 1: IPray2Buddha (1047 in chips) \r\nSeat 2: katarina1011 (1953 in chips) \r\nkatarina1011: posts small blind 15\r\nIPray2Buddha: posts big blind 30

\r\n*** HOLE CARDS ***\r\nDealt to IPray2Buddha [2c Ad]\r\nkatarina1011: calls 15\r\nIPray2Buddha: checks \r\n*** FLOP *** [6h Jd 7h]\r\nIPray2Buddha: checks \r\nkatarina1011: checks \r\n*** TURN *** [6h Jd 7h] [4h]\r\nIPray2Buddha: checks \r\nkatarina1011: checks \r\n*** RIVER *** [6h Jd 7h 4h] [Qs]\r\nIPray2Buddha: checks \r\nkatarina1011: bets 30\r\nIPray2Buddha: folds \r\nUncalled bet (30) returned to katarina1011\r\nkatarina1011 collected 60 from pot\r\nkatarina1011: doesn't show hand \r\n*** SUMMARY ***\r\nTotal pot 60 | Rake 0 \r\nBoard [6h Jd 7h 4h Qs]\r\nSeat 1: IPray2Buddha (big blind) folded on the River\r\nSeat 2: katarina1011 (button) (small blind) collected (60)\r\n\r\nHand #13: \r\n\r\nPokerStars Hand #222088751672: Tournament #3091025143, $28.78+$1.22 USD Hold'em No Limit - Level II (15/30) - 2021/01/01 8:57:14 ET\r\nTable '3091025143 1' 2-max Seat #1 is the button\r\nSeat 1: IPray2Buddha (1017 in chips) \r\nSeat 2: katarina1011 (1983 in chips) \r\nIPray2Buddha: posts small blind 15\r\nkatarina1011: posts big blind 30

\r\n*** HOLE CARDS ***\r\nDealt to IPray2Buddha [Ad 7c]\r\nIPray2Buddha: calls 15\r\nkatarina1011: checks \r\n*** FLOP *** [Kh 6c 5d]\r\nkatarina1011: checks \r\nIPray2Buddha: checks \r\n*** TURN *** [Kh 6c 5d] [Ts]\r\nkatarina1011: checks \r\nIPray2Buddha: checks \r\n*** RIVER *** [Kh 6c 5d Ts] [8d]\r\nkatarina1011: checks \r\nIPray2Buddha: checks \r\n*** SHOW DOWN ***\r\nkatarina1011: shows [Jc 2s] (high card King)\r\nIPray2Buddha: shows [Ad 7c] (high card Ace)\r\nIPray2Buddha collected 60 from pot\r\n*** SUMMARY ***\r\nTotal pot 60 | Rake 0 \r\nBoard [Kh 6c 5d Ts 8d]\r\nSeat 1: IPray2Buddha (button) (small blind) showed [Ad 7c] and won (60) with high card Ace\r\nSeat 2: katarina1011 (big blind) showed [Jc 2s] and lost with high card King\r\n\r\nHand #14: \r\n\r\nPokerStars Hand #222088763207: Tournament #3091025143, $28.78+$1.22 USD Hold'em No Limit - Level III (20/40) - 2021/01/01 8:57:50 ET\r\nTable '3091025143 1' 2-max Seat #2 is the button\r\nSeat 1: IPray2Buddha (1047 in chips) \r\nSeat 2: katarina1011 (1953 in chips) \r\nkatarina1011: posts small blind 20\r\nIPray2Buddha: posts big blind 40

\r\n*** HOLE CARDS ***\r\nDealt to IPray2Buddha [6s 4c]\r\nkatarina1011: raises 40 to 80\r\nIPray2Buddha: folds \r\nUncalled bet (40) returned to katarina1011\r\nkatarina1011 collected 80 from pot\r\nkatarina1011: doesn't show hand \r\n*** SUMMARY ***\r\nTotal pot 80 | Rake 0 \r\nSeat 1: IPray2Buddha (big blind) folded before Flop\r\nSeat 2: katarina1011 (button) (small blind) collected (80)\r\n\r\nHand #15: \r\n\r\nPokerStars Hand #222088768194: Tournament #3091025143, $28.78+$1.22 USD Hold'em No Limit - Level III (20/40) - 2021/01/01 8:58:05 ET\r\nTable '3091025143 1' 2-max Seat #1 is the button\r\nSeat 1: IPray2Buddha (1007 in chips) \r\nSeat 2: katarina1011 (1993 in chips) \r\nIPray2Buddha: posts small blind 20\r\nkatarina1011: posts big blind 40

\r\n*** HOLE CARDS ***\r\nDealt to IPray2Buddha [5d 7s]\r\nIPray2Buddha: calls 20\r\nkatarina1011: checks \r\n*** FLOP *** [3h 7c Qh]\r\nkatarina1011: checks \r\nIPray2Buddha: checks \r\n*** TURN *** [3h 7c Qh] [Ah]\r\nkatarina1011: checks \r\nIPray2Buddha: bets 40\r\nkatarina1011: calls 40\r\n*** RIVER *** [3h 7c Qh Ah] [9s]\r\nkatarina1011: checks \r\nIPray2Buddha: checks \r\n*** SHOW DOWN ***\r\nkatarina1011: shows [7h 8d] (a pair of Sevens)\r\nIPray2Buddha: shows [5d 7s] (a pair of Sevens)\r\nkatarina1011 collected 80 from pot\r\nIPray2Buddha collected 80 from pot\r\n*** SUMMARY ***\r\nTotal pot 160 | Rake 0 \r\nBoard [3h 7c Qh Ah 9s]\r\nSeat 1: IPray2Buddha (button) (small blind) showed [5d 7s] and won (80) with a pair of Sevens\r\nSeat 2: katarina1011 (big blind) showed [7h 8d] and won (80) with a pair of Sevens\r\n\r\nHand #16: \r\n\r\nPokerStars Hand #222088785289: Tournament #3091025143, $28.78+$1.22 USD Hold'em No Limit - Level III (20/40) - 2021/01/01 8:58:56 ET\r\nTable '3091025143 1' 2-max Seat #2 is the button\r\nSeat 1: IPray2Buddha (1007 in chips) \r\nSeat 2: katarina1011 (1993 in chips) \r\nkatarina1011: posts small blind 20\r\nIPray2Buddha: posts big blind 40

\r\n*** HOLE CARDS ***\r\nDealt to IPray2Buddha [3h 8d]\r\nkatarina1011: calls 20\r\nIPray2Buddha: checks \r\n*** FLOP *** [7d Ks 8s]\r\nIPray2Buddha: checks \r\nkatarina1011: bets 80\r\nIPray2Buddha: folds \r\nUncalled bet (80) returned to katarina1011\r\nkatarina1011 collected 80 from pot\r\nkatarina1011: doesn't show hand \r\n*** SUMMARY ***\r\nTotal pot 80 | Rake 0 \r\nBoard [7d Ks 8s]\r\nSeat 1: IPray2Buddha (big blind) folded on the Flop\r\nSeat 2: katarina1011 (button) (small blind) collected (80)\r\n\r\nHand #17: \r\n\r\nPokerStars Hand #222088798334: Tournament #3091025143, $28.78+$1.22 USD Hold'em No Limit - Level III (20/40) - 2021/01/01 8:59:35 ET\r\nTable '3091025143 1' 2-max Seat #1 is the button\r\nSeat 1: IPray2Buddha (967 in chips) \r\nSeat 2: katarina1011 (2033 in chips) \r\nIPray2Buddha: posts small blind 20\r\nkatarina1011: posts big blind 40

\r\n*** HOLE CARDS ***\r\nDealt to IPray2Buddha [Tc Ac]\r\nIPray2Buddha: raises 40 to 80\r\nkatarina1011: calls 40\r\n*** FLOP *** [2c 9s 4h]\r\nkatarina1011: checks \r\nIPray2Buddha: bets 48\r\nkatarina1011: calls 48\r\n*** TURN *** [2c 9s 4h] [Kd]\r\nkatarina1011: bets 128\r\nIPray2Buddha: folds \r\nUncalled bet (128) returned to katarina1011\r\nkatarina1011 collected 256 from pot\r\nkatarina1011: doesn't show hand \r\n*** SUMMARY ***\r\nTotal pot 256 | Rake 0 \r\nBoard [2c 9s 4h Kd]\r\nSeat 1: IPray2Buddha (button) (small blind) folded on the Turn\r\nSeat 2: katarina1011 (big blind) collected (256)\r\n\r\nHand #18: \r\n\r\nPokerStars Hand #222088808051: Tournament #3091025143, $28.78+$1.22 USD Hold'em No Limit - Level III (20/40) - 2021/01/01 9:00:04 ET\r\nTable '3091025143 1' 2-max Seat #2 is the button\r\nSeat 1: IPray2Buddha (839 in chips) \r\nSeat 2: katarina1011 (2161 in chips) \r\nkatarina1011: posts small blind 20\r\nIPray2Buddha: posts big blind 40

\r\n*** HOLE CARDS ***\r\nDealt to IPray2Buddha [Jh 6s]\r\nkatarina1011: calls 20\r\nIPray2Buddha: checks \r\n*** FLOP *** [Kd 4s 8c]\r\nIPray2Buddha: checks \r\nkatarina1011: bets 80\r\nIPray2Buddha: folds \r\nUncalled bet (80) returned to katarina1011\r\nkatarina1011 collected 80 from pot\r\nkatarina1011: doesn't show hand \r\n*** SUMMARY ***\r\nTotal pot 80 | Rake 0 \r\nBoard [Kd 4s 8c]\r\nSeat 1: IPray2Buddha (big blind) folded on the Flop\r\nSeat 2: katarina1011 (button) (small blind) collected (80)\r\n\r\nHand #19: \r\n\r\nPokerStars Hand #222088817000: Tournament #3091025143, $28.78+$1.22 USD Hold'em No Limit - Level III (20/40) - 2021/01/01 9:00:30 ET\r\nTable '3091025143 1' 2-max Seat #1 is the button\r\nSeat 1: IPray2Buddha (799 in chips) \r\nSeat 2: katarina1011 (2201 in chips) \r\nIPray2Buddha: posts small blind 20\r\nkatarina1011: posts big blind 40

\r\n*** HOLE CARDS ***\r\nDealt to IPray2Buddha [Tc Jd]\r\nIPray2Buddha: raises 40 to 80\r\nkatarina1011: calls 40\r\n*** FLOP *** [As 7d Td]\r\nkatarina1011: checks \r\nIPray2Buddha: bets 107\r\nkatarina1011: folds \r\nUncalled bet (107) returned to IPray2Buddha\r\nIPray2Buddha collected 160 from pot\r\n*** SUMMARY ***\r\nTotal pot 160 | Rake 0 \r\nBoard [As 7d Td]\r\nSeat 1: IPray2Buddha (button) (small blind) collected (160)\r\nSeat 2: katarina1011 (big blind) folded on the Flop\r\n\r\nHand #20: \r\n\r\nPokerStars Hand #222088823027: Tournament #3091025143, $28.78+$1.22 USD Hold'em No Limit - Level IV (25/50) - 2021/01/01 9:00:47 ET\r\nTable '3091025143 1' 2-max Seat #2 is the button\r\nSeat 1: IPray2Buddha (879 in chips) \r\nSeat 2: katarina1011 (2121 in chips) \r\nkatarina1011: posts small blind 25\r\nIPray2Buddha: posts big blind 50

\r\n*** HOLE CARDS ***\r\nDealt to IPray2Buddha [Kd 6h]\r\nkatarina1011: calls 25\r\nIPray2Buddha: checks \r\n*** FLOP *** [As Jc 4d]\r\nIPray2Buddha: checks \r\nkatarina1011: bets 50\r\nIPray2Buddha: calls 50\r\n*** TURN *** [As Jc 4d] [6d]\r\nIPray2Buddha: checks \r\nkatarina1011: checks \r\n*** RIVER *** [As Jc 4d 6d] [7s]\r\nIPray2Buddha: checks \r\nkatarina1011: bets 50\r\nIPray2Buddha: calls 50\r\n*** SHOW DOWN ***\r\nkatarina1011: shows [Kh 6s] (a pair of Sixes)\r\nIPray2Buddha: shows [Kd 6h] (a pair of Sixes)\r\nIPray2Buddha collected 150 from pot\r\nkatarina1011 collected 150 from pot\r\n*** SUMMARY ***\r\nTotal pot 300 | Rake 0 \r\nBoard [As Jc 4d 6d 7s]\r\nSeat 1: IPray2Buddha (big blind) showed [Kd 6h] and won (150) with a pair of Sixes\r\nSeat 2: katarina1011 (button) (small blind) showed [Kh 6s] and won (150) with a pair of Sixes\r\n\r\nHand #21: \r\n\r\nPokerStars Hand #222088841562: Tournament #3091025143, $28.78+$1.22 USD Hold'em No Limit - Level IV (25/50) - 2021/01/01 9:01:35 ET\r\nTable '3091025143 1' 2-max Seat #1 is the button\r\nSeat 1: IPray2Buddha (879 in chips) \r\nSeat 2: katarina1011 (2121 in chips) \r\nIPray2Buddha: posts small blind 25\r\nkatarina1011: posts big blind 50

\r\n*** HOLE CARDS ***\r\nDealt to IPray2Buddha [Ah 9c]\r\nIPray2Buddha: raises 829 to 879 and is all-in\r\nkatarina1011: folds \r\nUncalled bet (829) returned to IPray2Buddha\r\nIPray2Buddha collected 100 from pot\r\n*** SUMMARY ***\r\nTotal pot 100 | Rake 0 \r\nSeat 1: IPray2Buddha (button) (small blind) collected (100)\r\nSeat 2: katarina1011 (big blind) folded before Flop\r\n\r\nHand #22: \r\n\r\nPokerStars Hand #222088844971: Tournament #3091025143, $28.78+$1.22 USD Hold'em No Limit - Level IV (25/50) - 2021/01/01 9:01:44 ET\r\nTable '3091025143 1' 2-max Seat #2 is the button\r\nSeat 1: IPray2Buddha (929 in chips) \r\nSeat 2: katarina1011 (2071 in chips) \r\nkatarina1011: posts small blind 25\r\nIPray2Buddha: posts big blind 50

\r\n*** HOLE CARDS ***\r\nDealt to IPray2Buddha [Js Qc]\r\nkatarina1011: folds \r\nUncalled bet (25) returned to IPray2Buddha\r\nIPray2Buddha collected 50 from pot\r\n*** SUMMARY ***\r\nTotal pot 50 | Rake 0 \r\nSeat 1: IPray2Buddha (big blind) collected (50)\r\nSeat 2: katarina1011 (button) (small blind) folded before Flop\r\n\r\nHand #23: \r\n\r\nPokerStars Hand #222088849006: Tournament #3091025143, $28.78+$1.22 USD Hold'em No Limit - Level IV (25/50) - 2021/01/01 9:01:54 ET\r\nTable '3091025143 1' 2-max Seat #1 is the button\r\nSeat 1: IPray2Buddha (954 in chips) \r\nSeat 2: katarina1011 (2046 in chips) \r\nIPray2Buddha: posts small blind 25\r\nkatarina1011: posts big blind 50

\r\n*** HOLE CARDS ***\r\nDealt to IPray2Buddha [Th Tc]\r\nIPray2Buddha: raises 50 to 100\r\nkatarina1011: raises 1946 to 2046 and is all-in\r\nIPray2Buddha: calls 854 and is all-in\r\nUncalled bet (1092) returned to katarina1011\r\n*** FLOP *** [7d 5s 3h]\r\n*** TURN *** [7d 5s 3h] [9h]\r\n*** RIVER *** [7d 5s 3h 9h] [7s]\r\n*** SHOW DOWN ***\r\nkatarina1011: shows [2h Ac] (a pair of Sevens)\r\nIPray2Buddha: shows [Th Tc] (two pair, Tens and Sevens)\r\nIPray2Buddha collected 1908 from pot\r\n*** SUMMARY ***\r\nTotal pot 1908 | Rake 0 \r\nBoard [7d 5s 3h 9h 7s]\r\nSeat 1: IPray2Buddha (button) (small blind) showed [Th Tc] and won (1908) with two pair, Tens and Sevens\r\nSeat 2: katarina1011 (big blind) showed [2h Ac] and lost with a pair of Sevens\r\n\r\nHand #24: \r\n\r\nPokerStars Hand #222088863422: Tournament #3091025143, $28.78+$1.22 USD Hold'em No Limit - Level IV (25/50) - 2021/01/01 9:02:29 ET\r\nTable '3091025143 1' 2-max Seat #2 is the button\r\nSeat 1: IPray2Buddha (1908 in chips) \r\nSeat 2: katarina1011 (1092 in chips) \r\nkatarina1011: posts small blind 25\r\nIPray2Buddha: posts big blind 50

\r\n*** HOLE CARDS ***\r\nDealt to IPray2Buddha [2s 5d]\r\nkatarina1011: raises 1042 to 1092 and is all-in\r\nIPray2Buddha: folds \r\nUncalled bet (1042) returned to katarina1011\r\nkatarina1011 collected 100 from pot\r\nkatarina1011: doesn't show hand \r\n*** SUMMARY ***\r\nTotal pot 100 | Rake 0 \r\nSeat 1: IPray2Buddha (big blind) folded before Flop\r\nSeat 2: katarina1011 (button) (small blind) collected (100)\r\n\r\nHand #25: \r\n\r\nPokerStars Hand #222088868727: Tournament #3091025143, $28.78+$1.22 USD Hold'em No Limit - Level IV (25/50) - 2021/01/01 9:02:42 ET\r\nTable '3091025143 1' 2-max Seat #1 is the button\r\nSeat 1: IPray2Buddha (1858 in chips) \r\nSeat 2: katarina1011 (1142 in chips) \r\nIPray2Buddha: posts small blind 25\r\nkatarina1011: posts big blind 50

\r\n*** HOLE CARDS ***\r\nDealt to IPray2Buddha [3c 9c]\r\nIPray2Buddha: calls 25\r\nkatarina1011: raises 50 to 100\r\nIPray2Buddha: calls 50\r\n*** FLOP *** [Js Qc 3s]\r\nkatarina1011: bets 50\r\nIPray2Buddha: calls 50\r\n*** TURN *** [Js Qc 3s] [5c]\r\nkatarina1011: bets 100\r\nIPray2Buddha: calls 100\r\n*** RIVER *** [Js Qc 3s 5c] [2d]\r\nkatarina1011: bets 250\r\nIPray2Buddha: folds \r\nUncalled bet (250) returned to katarina1011\r\nkatarina1011 collected 500 from pot\r\nkatarina1011: doesn't show hand \r\n*** SUMMARY ***\r\nTotal pot 500 | Rake 0 \r\nBoard [Js Qc 3s 5c 2d]\r\nSeat 1: IPray2Buddha (button) (small blind) folded on the River\r\nSeat 2: katarina1011 (big blind) collected (500)\r\n\r\nHand #26: \r\n\r\nPokerStars Hand #222088888212: Tournament #3091025143, $28.78+$1.22 USD Hold'em No Limit - Level IV (25/50) - 2021/01/01 9:03:30 ET\r\nTable '3091025143 1' 2-max Seat #2 is the button\r\nSeat 1: IPray2Buddha (1608 in chips) \r\nSeat 2: katarina1011 (1392 in chips) \r\nkatarina1011: posts small blind 25\r\nIPray2Buddha: posts big blind 50

\r\n*** HOLE CARDS ***\r\nDealt to IPray2Buddha [Js Ts]\r\nkatarina1011: calls 25\r\nIPray2Buddha: raises 95 to 145\r\nkatarina1011: folds \r\nUncalled bet (95) returned to IPray2Buddha\r\nIPray2Buddha collected 100 from pot\r\n*** SUMMARY ***\r\nTotal pot 100 | Rake 0 \r\nSeat 1: IPray2Buddha (big blind) collected (100)\r\nSeat 2: katarina1011 (button) (small blind) folded before Flop\r\n\r\nHand #27: \r\n\r\nPokerStars Hand #222088895026: Tournament #3091025143, $28.78+$1.22 USD Hold'em No Limit - Level V (30/60) - 2021/01/01 9:03:46 ET\r\nTable '3091025143 1' 2-max Seat #1 is the button\r\nSeat 1: IPray2Buddha (1658 in chips) \r\nSeat 2: katarina1011 (1342 in chips) \r\nIPray2Buddha: posts small blind 30\r\nkatarina1011: posts big blind 60

\r\n*** HOLE CARDS ***\r\nDealt to IPray2Buddha [Tc 3h]\r\nIPray2Buddha: calls 30\r\nkatarina1011: checks \r\n*** FLOP *** [Jc Jh Kh]\r\nkatarina1011: checks \r\nIPray2Buddha: checks \r\n*** TURN *** [Jc Jh Kh] [6s]\r\nkatarina1011: bets 60\r\nIPray2Buddha: folds \r\nUncalled bet (60) returned to katarina1011\r\nkatarina1011 collected 120 from pot\r\nkatarina1011: doesn't show hand \r\n*** SUMMARY ***\r\nTotal pot 120 | Rake 0 \r\nBoard [Jc Jh Kh 6s]\r\nSeat 1: IPray2Buddha (button) (small blind) folded on the Turn\r\nSeat 2: katarina1011 (big blind) collected (120)\r\n\r\nHand #28: \r\n\r\nPokerStars Hand #222088906321: Tournament #3091025143, $28.78+$1.22 USD Hold'em No Limit - Level V (30/60) - 2021/01/01 9:04:13 ET\r\nTable '3091025143 1' 2-max Seat #2 is the button\r\nSeat 1: IPray2Buddha (1598 in chips) \r\nSeat 2: katarina1011 (1402 in chips) \r\nkatarina1011: posts small blind 30\r\nIPray2Buddha: posts big blind 60

\r\n*** HOLE CARDS ***\r\nDealt to IPray2Buddha [Td Kd]\r\nkatarina1011: calls 30\r\nIPray2Buddha: raises 114 to 174\r\nkatarina1011: folds \r\nUncalled bet (114) returned to IPray2Buddha\r\nIPray2Buddha collected 120 from pot\r\n*** SUMMARY ***\r\nTotal pot 120 | Rake 0 \r\nSeat 1: IPray2Buddha (big blind) collected (120)\r\nSeat 2: katarina1011 (button) (small blind) folded before Flop\r\n\r\nHand #29: \r\n\r\nPokerStars Hand #222088911377: Tournament #3091025143, $28.78+$1.22 USD Hold'em No Limit - Level V (30/60) - 2021/01/01 9:04:25 ET\r\nTable '3091025143 1' 2-max Seat #1 is the button\r\nSeat 1: IPray2Buddha (1658 in chips) \r\nSeat 2: katarina1011 (1342 in chips) \r\nIPray2Buddha: posts small blind 30\r\nkatarina1011: posts big blind 60

\r\n*** HOLE CARDS ***\r\nDealt to IPray2Buddha [7c Jc]\r\nIPray2Buddha: raises 60 to 120\r\nkatarina1011: folds \r\nUncalled bet (60) returned to IPray2Buddha\r\nIPray2Buddha collected 120 from pot\r\n*** SUMMARY ***\r\nTotal pot 120 | Rake 0 \r\nSeat 1: IPray2Buddha (button) (small blind) collected (120)\r\nSeat 2: katarina1011 (big blind) folded before Flop\r\n\r\nHand #30: \r\n\r\nPokerStars Hand #222088914247: Tournament #3091025143, $28.78+$1.22 USD Hold'em No Limit - Level V (30/60) - 2021/01/01 9:04:32 ET\r\nTable '3091025143 1' 2-max Seat #2 is the button\r\nSeat 1: IPray2Buddha (1718 in chips) \r\nSeat 2: katarina1011 (1282 in chips) \r\nkatarina1011: posts small blind 30\r\nIPray2Buddha: posts big blind 60

\r\n*** HOLE CARDS ***\r\nDealt to IPray2Buddha [3d Ts]\r\nkatarina1011: folds \r\nUncalled bet (30) returned to IPray2Buddha\r\nIPray2Buddha collected 60 from pot\r\n*** SUMMARY ***\r\nTotal pot 60 | Rake 0 \r\nSeat 1: IPray2Buddha (big blind) collected (60)\r\nSeat 2: katarina1011 (button) (small blind) folded before Flop\r\n\r\nHand #31: \r\n\r\nPokerStars Hand #222088915915: Tournament #3091025143, $28.78+$1.22 USD Hold'em No Limit - Level V (30/60) - 2021/01/01 9:04:36 ET\r\nTable '3091025143 1' 2-max Seat #1 is the button\r\nSeat 1: IPray2Buddha (1748 in chips) \r\nSeat 2: katarina1011 (1252 in chips) \r\nIPray2Buddha: posts small blind 30\r\nkatarina1011: posts big blind 60

\r\n*** HOLE CARDS ***\r\nDealt to IPray2Buddha [2h 3c]\r\nIPray2Buddha: calls 30\r\nkatarina1011: checks \r\n*** FLOP *** [7h 5c 4d]\r\nkatarina1011: checks \r\nIPray2Buddha: checks \r\n*** TURN *** [7h 5c 4d] [6h]\r\nkatarina1011: checks \r\nIPray2Buddha: checks \r\n*** RIVER *** [7h 5c 4d 6h] [Qd]\r\nkatarina1011: bets 180\r\nIPray2Buddha: calls 180\r\n*** SHOW DOWN ***\r\nkatarina1011: shows [Kc 4s] (a pair of Fours)\r\nIPray2Buddha: shows [2h 3c] (a straight, Three to Seven)\r\nIPray2Buddha collected 480 from pot\r\n*** SUMMARY ***\r\nTotal pot 480 | Rake 0 \r\nBoard [7h 5c 4d 6h Qd]\r\nSeat 1: IPray2Buddha (button) (small blind) showed [2h 3c] and won (480) with a straight, Three to Seven\r\nSeat 2: katarina1011 (big blind) showed [Kc 4s] and lost with a pair of Fours\r\n\r\nHand #32: \r\n\r\nPokerStars Hand #222088927833: Tournament #3091025143, $28.78+$1.22 USD Hold'em No Limit - Level V (30/60) - 2021/01/01 9:05:05 ET\r\nTable '3091025143 1' 2-max Seat #2 is the button\r\nSeat 1: IPray2Buddha (1988 in chips) \r\nSeat 2: katarina1011 (1012 in chips) \r\nkatarina1011: posts small blind 30\r\nIPray2Buddha: posts big blind 60

\r\n*** HOLE CARDS ***\r\nDealt to IPray2Buddha [4h Jh]\r\nkatarina1011: calls 30\r\nIPray2Buddha: checks \r\n*** FLOP *** [Kd 8h 7s]\r\nIPray2Buddha: checks \r\nkatarina1011: bets 60\r\nIPray2Buddha: folds \r\nUncalled bet (60) returned to katarina1011\r\nkatarina1011 collected 120 from pot\r\nkatarina1011: doesn't show hand \r\n*** SUMMARY ***\r\nTotal pot 120 | Rake 0 \r\nBoard [Kd 8h 7s]\r\nSeat 1: IPray2Buddha (big blind) folded on the Flop\r\nSeat 2: katarina1011 (button) (small blind) collected (120)\r\n\r\nHand #33: \r\n\r\nPokerStars Hand #222088941862: Tournament #3091025143, $28.78+$1.22 USD Hold'em No Limit - Level V (30/60) - 2021/01/01 9:05:39 ET\r\nTable '3091025143 1' 2-max Seat #1 is the button\r\nSeat 1: IPray2Buddha (1928 in chips) \r\nSeat 2: katarina1011 (1072 in chips) \r\nIPray2Buddha: posts small blind 30\r\nkatarina1011: posts big blind 60

\r\n*** HOLE CARDS ***\r\nDealt to IPray2Buddha [9d 6s]\r\nIPray2Buddha: calls 30\r\nkatarina1011: checks \r\n*** FLOP *** [Ts 3h 4s]\r\nkatarina1011: bets 60\r\nIPray2Buddha: folds \r\nUncalled bet (60) returned to katarina1011\r\nkatarina1011 collected 120 from pot\r\nkatarina1011: doesn't show hand \r\n*** SUMMARY ***\r\nTotal pot 120 | Rake 0 \r\nBoard [Ts 3h 4s]\r\nSeat 1: IPray2Buddha (button) (small blind) folded on the Flop\r\nSeat 2: katarina1011 (big blind) collected (120)\r\n\r\nHand #34: \r\n\r\nPokerStars Hand #222088951316: Tournament #3091025143, $28.78+$1.22 USD Hold'em No Limit - Level V (30/60) - 2021/01/01 9:06:02 ET\r\nTable '3091025143 1' 2-max Seat #2 is the button\r\nSeat 1: IPray2Buddha (1868 in chips) \r\nSeat 2: katarina1011 (1132 in chips) \r\nkatarina1011: posts small blind 30\r\nIPray2Buddha: posts big blind 60

\r\n*** HOLE CARDS ***\r\nDealt to IPray2Buddha [8s 7d]\r\nkatarina1011: calls 30\r\nIPray2Buddha: checks \r\n*** FLOP *** [9c Qd 3d]\r\nIPray2Buddha: checks \r\nkatarina1011: checks \r\n*** TURN *** [9c Qd 3d] [7c]\r\nIPray2Buddha: bets 60\r\nkatarina1011: calls 60\r\n*** RIVER *** [9c Qd 3d 7c] [2c]\r\nIPray2Buddha: checks \r\nkatarina1011: bets 240\r\nIPray2Buddha: calls 240\r\n*** SHOW DOWN ***\r\nkatarina1011: shows [Kc Ah] (high card Ace)\r\nIPray2Buddha: shows [8s 7d] (a pair of Sevens)\r\nIPray2Buddha collected 720 from pot\r\n*** SUMMARY ***\r\nTotal pot 720 | Rake 0 \r\nBoard [9c Qd 3d 7c 2c]\r\nSeat 1: IPray2Buddha (big blind) showed [8s 7d] and won (720) with a pair of Sevens\r\nSeat 2: katarina1011 (button) (small blind) showed [Kc Ah] and lost with high card Ace\r\n\r\nHand #35: \r\n\r\nPokerStars Hand #222088975004: Tournament #3091025143, $28.78+$1.22 USD Hold'em No Limit - Level VI (40/80) - 2021/01/01 9:06:59 ET\r\nTable '3091025143 1' 2-max Seat #1 is the button\r\nSeat 1: IPray2Buddha (2228 in chips) \r\nSeat 2: katarina1011 (772 in chips) \r\nIPray2Buddha: posts small blind 40\r\nkatarina1011: posts big blind 80

\r\n*** HOLE CARDS ***\r\nDealt to IPray2Buddha [5d 5c]\r\nIPray2Buddha: calls 40\r\nkatarina1011: checks \r\n*** FLOP *** [As Qs 4h]\r\nkatarina1011: checks \r\nIPray2Buddha: bets 80\r\nkatarina1011: folds \r\nUncalled bet (80) returned to IPray2Buddha\r\nIPray2Buddha collected 160 from pot\r\n*** SUMMARY ***\r\nTotal pot 160 | Rake 0 \r\nBoard [As Qs 4h]\r\nSeat 1: IPray2Buddha (button) (small blind) collected (160)\r\nSeat 2: katarina1011 (big blind) folded on the Flop\r\n\r\nHand #36: \r\n\r\nPokerStars Hand #222088983929: Tournament #3091025143, $28.78+$1.22 USD Hold'em No Limit - Level VI (40/80) - 2021/01/01 9:07:20 ET\r\nTable '3091025143 1' 2-max Seat #2 is the button\r\nSeat 1: IPray2Buddha (2308 in chips) \r\nSeat 2: katarina1011 (692 in chips) \r\nkatarina1011: posts small blind 40\r\nIPray2Buddha: posts big blind 80

\r\n*** HOLE CARDS ***\r\nDealt to IPray2Buddha [9d 6s]\r\nkatarina1011: raises 612 to 692 and is all-in\r\nIPray2Buddha: folds \r\nUncalled bet (612) returned to katarina1011\r\nkatarina1011 collected 160 from pot\r\nkatarina1011: doesn't show hand \r\n*** SUMMARY ***\r\nTotal pot 160 | Rake 0 \r\nSeat 1: IPray2Buddha (big blind) folded before Flop\r\nSeat 2: katarina1011 (button) (small blind) collected (160)\r\n\r\nHand #37: \r\n\r\nPokerStars Hand #222088988235: Tournament #3091025143, $28.78+$1.22 USD Hold'em No Limit - Level VI (40/80) - 2021/01/01 9:07:30 ET\r\nTable '3091025143 1' 2-max Seat #1 is the button\r\nSeat 1: IPray2Buddha (2228 in chips) \r\nSeat 2: katarina1011 (772 in chips) \r\nIPray2Buddha: posts small blind 40\r\nkatarina1011: posts big blind 80

\r\n*** HOLE CARDS ***\r\nDealt to IPray2Buddha [Qd 9d]\r\nIPray2Buddha: raises 80 to 160\r\nkatarina1011: calls 80\r\n*** FLOP *** [4s 6d 8h]\r\nkatarina1011: checks \r\nIPray2Buddha: checks \r\n*** TURN *** [4s 6d 8h] [5c]\r\nkatarina1011: checks \r\nIPray2Buddha: checks \r\n*** RIVER *** [4s 6d 8h 5c] [2c]\r\nkatarina1011: checks \r\nIPray2Buddha: checks \r\n*** SHOW DOWN ***\r\nkatarina1011: shows [2h Ah] (a pair of Deuces)\r\n \r\nkatarina1011 collected 320 from pot\r\n*** SUMMARY ***\r\nTotal pot 320 | Rake 0 \r\nBoard [4s 6d 8h 5c 2c]\r\nSeat 1: IPray2Buddha (button) (small blind) mucked [Qd 9d]\r\nSeat 2: katarina1011 (big blind) showed [2h Ah] and won (320) with a pair of Deuces\r\n\r\nHand #38: \r\n\r\nPokerStars Hand #222089001612: Tournament #3091025143, $28.78+$1.22 USD Hold'em No Limit - Level VI (40/80) - 2021/01/01 9:08:03 ET\r\nTable '3091025143 1' 2-max Seat #2 is the button\r\nSeat 1: IPray2Buddha (2068 in chips) \r\nSeat 2: katarina1011 (932 in chips) \r\nkatarina1011: posts small blind 40\r\nIPray2Buddha: posts big blind 80

\r\n*** HOLE CARDS ***\r\nDealt to IPray2Buddha [8h As]\r\nkatarina1011: calls 40\r\nIPray2Buddha: raises 1520 to 1600\r\nkatarina1011: folds \r\nUncalled bet (1520) returned to IPray2Buddha\r\nIPray2Buddha collected 160 from pot\r\n*** SUMMARY ***\r\nTotal pot 160 | Rake 0 \r\nSeat 1: IPray2Buddha (big blind) collected (160)\r\nSeat 2: katarina1011 (button) (small blind) folded before Flop\r\n\r\nHand #39: \r\n\r\nPokerStars Hand #222089005679: Tournament #3091025143, $28.78+$1.22 USD Hold'em No Limit - Level VI (40/80) - 2021/01/01 9:08:12 ET\r\nTable '3091025143 1' 2-max Seat #1 is the button\r\nSeat 1: IPray2Buddha (2148 in chips) \r\nSeat 2: katarina1011 (852 in chips) \r\nIPray2Buddha: posts small blind 40\r\nkatarina1011: posts big blind 80

\r\n*** HOLE CARDS ***\r\nDealt to IPray2Buddha [Qs 8h]\r\nIPray2Buddha: calls 40\r\nkatarina1011: raises 772 to 852 and is all-in\r\nIPray2Buddha: folds \r\nUncalled bet (772) returned to katarina1011\r\nkatarina1011 collected 160 from pot\r\nkatarina1011: doesn't show hand \r\n*** SUMMARY ***\r\nTotal pot 160 | Rake 0 \r\nSeat 1: IPray2Buddha (button) (small blind) folded before Flop\r\nSeat 2: katarina1011 (big blind) collected (160)\r\n\r\nHand #40: \r\n\r\nPokerStars Hand #222089009810: Tournament #3091025143, $28.78+$1.22 USD Hold'em No Limit - Level VI (40/80) - 2021/01/01 9:08:22 ET\r\nTable '3091025143 1' 2-max Seat #2 is the button\r\nSeat 1: IPray2Buddha (2068 in chips) \r\nSeat 2: katarina1011 (932 in chips) \r\nkatarina1011: posts small blind 40\r\nIPray2Buddha: posts big blind 80

\r\n*** HOLE CARDS ***\r\nDealt to IPray2Buddha [Td Jh]\r\nkatarina1011: calls 40\r\nIPray2Buddha: raises 120 to 200\r\nkatarina1011: raises 732 to 932 and is all-in\r\nIPray2Buddha: calls 732\r\n*** FLOP *** [Jd Th Ah]\r\n*** TURN *** [Jd Th Ah] [Ts]\r\n*** RIVER *** [Jd Th Ah Ts] [8s]\r\n*** SHOW DOWN ***\r\nIPray2Buddha: shows [Td Jh] (a full house, Tens full of Jacks)\r\nkatarina1011: shows [Tc As] (a full house, Tens full of Aces)\r\nkatarina1011 collected 1864 from pot\r\n*** SUMMARY ***\r\nTotal pot 1864 | Rake 0 \r\nBoard [Jd Th Ah Ts 8s]\r\nSeat 1: IPray2Buddha (big blind) showed [Td Jh] and lost with a full house, Tens full of Jacks\r\nSeat 2: katarina1011 (button) (small blind) showed [Tc As] and won (1864) with a full house, Tens full of Aces\r\n\r\n\r\n\r\nHand #42: \r\n\r\nPokerStars Hand #222089025500: Tournament #3091025143, $28.78+$1.22 USD Hold'em No Limit - Level VI (40/80) - 2021/01/01 9:09:00 ET\r\nTable '3091025143 1' 2-max Seat #2 is the button\r\nSeat 1: IPray2Buddha (1056 in chips) \r\nSeat 2: katarina1011 (1944 in chips) \r\nkatarina1011: posts small blind 40\r\nIPray2Buddha: posts big blind 80

\r\n*** HOLE CARDS ***\r\nDealt to IPray2Buddha [Td Tc]\r\nkatarina1011: calls 40\r\nIPray2Buddha: raises 144 to 224\r\nkatarina1011: folds \r\nUncalled bet (144) returned to IPray2Buddha\r\nIPray2Buddha collected 160 from pot\r\n*** SUMMARY ***\r\nTotal pot 160 | Rake 0 \r\nSeat 1: IPray2Buddha (big blind) collected (160)\r\nSeat 2: katarina1011 (button) (small blind) folded before Flop\r\n\r\nHand #43: \r\n\r\nPokerStars Hand #222089032128: Tournament #3091025143, $28.78+$1.22 USD Hold'em No Limit - Level VI (40/80) - 2021/01/01 9:09:16 ET\r\nTable '3091025143 1' 2-max Seat #1 is the button\r\nSeat 1: IPray2Buddha (1136 in chips) \r\nSeat 2: katarina1011 (1864 in chips) \r\nIPray2Buddha: posts small blind 40\r\nkatarina1011: posts big blind 80

\r\n*** HOLE CARDS ***\r\nDealt to IPray2Buddha [Ks 7d]\r\nIPray2Buddha: calls 40\r\nkatarina1011: checks \r\n*** FLOP *** [3h Ts Qs]\r\nkatarina1011: checks \r\nIPray2Buddha: checks \r\n*** TURN *** [3h Ts Qs] [2s]\r\nkatarina1011: bets 80\r\nIPray2Buddha: calls 80\r\n*** RIVER *** [3h Ts Qs 2s] [5s]\r\nkatarina1011: checks \r\nIPray2Buddha: bets 480\r\nkatarina1011: folds \r\nUncalled bet (480) returned to IPray2Buddha\r\nIPray2Buddha collected 320 from pot\r\n*** SUMMARY ***\r\nTotal pot 320 | Rake 0 \r\nBoard [3h Ts Qs 2s 5s]\r\nSeat 1: IPray2Buddha (button) (small blind) collected (320)\r\nSeat 2: katarina1011 (big blind) folded on the River\r\n\r\nHand #44: \r\n\r\nPokerStars Hand #222089047363: Tournament #3091025143, $28.78+$1.22 USD Hold'em No Limit - Level VII (50/100) - 2021/01/01 9:09:52 ET\r\nTable '3091025143 1' 2-max Seat #2 is the button\r\nSeat 1: IPray2Buddha (1296 in chips) \r\nSeat 2: katarina1011 (1704 in chips) \r\nkatarina1011: posts small blind 50\r\nIPray2Buddha: posts big blind 100

\r\n*** HOLE CARDS ***\r\nDealt to IPray2Buddha [4h 9h]\r\nkatarina1011: folds \r\nUncalled bet (50) returned to IPray2Buddha\r\nIPray2Buddha collected 100 from pot\r\n*** SUMMARY ***\r\nTotal pot 100 | Rake 0 \r\nSeat 1: IPray2Buddha (big blind) collected (100)\r\nSeat 2: katarina1011 (button) (small blind) folded before Flop\r\n\r\nHand #45: \r\n\r\nPokerStars Hand #222089049220: Tournament #3091025143, $28.78+$1.22 USD Hold'em No Limit - Level VII (50/100) - 2021/01/01 9:09:57 ET\r\nTable '3091025143 1' 2-max Seat #1 is the button\r\nSeat 1: IPray2Buddha (1346 in chips) \r\nSeat 2: katarina1011 (1654 in chips) \r\nIPray2Buddha: posts small blind 50\r\nkatarina1011: posts big blind 100

\r\n*** HOLE CARDS ***\r\nDealt to IPray2Buddha [Kd Ks]\r\n\r\n\r\n\r\n\r\n\r\nIPray2Buddha: folds\r\n\r\nUncalled bet (50) returned to katarina1011\r\nkatarina1011 collected 100 from pot\r\nkatarina1011: doesn't show hand\r\n\r\n*** SUMMARY ***\r\nTotal pot 100 | Rake 0 \r\nSeat 1: IPray2Buddha (button) (small blind) folded before Flop\r\nSeat 2: katarina1011 (big blind) collected (100)\r\n\r\nHand #46: \r\n\r\nPokerStars Hand #222089061525: Tournament #3091025143, $28.78+$1.22 USD Hold'em No Limit - Level VII (50/100) - 2021/01/01 9:10:26 ET\r\nTable '3091025143 1' 2-max Seat #2 is the button\r\nSeat 1: IPray2Buddha (1296 in chips) \r\nSeat 2: katarina1011 (1704 in chips) \r\nkatarina1011: posts small blind 50\r\nIPray2Buddha: posts big blind 100

\r\n*** HOLE CARDS ***\r\nDealt to IPray2Buddha [Tc 6s]\r\nkatarina1011: raises 1604 to 1704 and is all-in\r\nIPray2Buddha: folds \r\nUncalled bet (1604) returned to katarina1011\r\nkatarina1011 collected 200 from pot\r\nkatarina1011: doesn't show hand \r\n*** SUMMARY ***\r\nTotal pot 200 | Rake 0 \r\nSeat 1: IPray2Buddha (big blind) folded before Flop\r\nSeat 2: katarina1011 (button) (small blind) collected (200)\r\n\r\nHand #47: \r\n\r\nPokerStars Hand #222089065076: Tournament #3091025143, $28.78+$1.22 USD Hold'em No Limit - Level VII (50/100) - 2021/01/01 9:10:34 ET\r\nTable '3091025143 1' 2-max Seat #1 is the button\r\nSeat 1: IPray2Buddha (1196 in chips) \r\nSeat 2: katarina1011 (1804 in chips) \r\nIPray2Buddha: posts small blind 50\r\nkatarina1011: posts big blind 100

\r\n*** HOLE CARDS ***\r\nDealt to IPray2Buddha [Jc 9h]\r\nIPray2Buddha: raises 100 to 200\r\nkatarina1011: folds \r\nUncalled bet (100) returned to IPray2Buddha\r\nIPray2Buddha collected 200 from pot\r\n*** SUMMARY ***\r\nTotal pot 200 | Rake 0 \r\nSeat 1: IPray2Buddha (button) (small blind) collected (200)\r\nSeat 2: katarina1011 (big blind) folded before Flop\r\n\r\nHand #48: \r\n\r\nPokerStars Hand #222089071403: Tournament #3091025143, $28.78+$1.22 USD Hold'em No Limit - Level VII (50/100) - 2021/01/01 9:10:49 ET\r\nTable '3091025143 1' 2-max Seat #2 is the button\r\nSeat 1: IPray2Buddha (1296 in chips) \r\nSeat 2: katarina1011 (1704 in chips) \r\nkatarina1011: posts small blind 50\r\nIPray2Buddha: posts big blind 100

\r\n*** HOLE CARDS ***\r\nDealt to IPray2Buddha [4h Td]\r\nkatarina1011: raises 1604 to 1704 and is all-in\r\nIPray2Buddha: folds \r\nUncalled bet (1604) returned to katarina1011\r\nkatarina1011 collected 200 from pot\r\nkatarina1011: doesn't show hand \r\n*** SUMMARY ***\r\nTotal pot 200 | Rake 0 \r\nSeat 1: IPray2Buddha (big blind) folded before Flop\r\nSeat 2: katarina1011 (button) (small blind) collected (200)\r\n\r\nHand #49: \r\n\r\nPokerStars Hand #222089075298: Tournament #3091025143, $28.78+$1.22 USD Hold'em No Limit - Level VII (50/100) - 2021/01/01 9:10:59 ET\r\nTable '3091025143 1' 2-max Seat #1 is the button\r\nSeat 1: IPray2Buddha (1196 in chips) \r\nSeat 2: katarina1011 (1804 in chips) \r\nIPray2Buddha: posts small blind 50\r\nkatarina1011: posts big blind 100

\r\n*** HOLE CARDS ***\r\nDealt to IPray2Buddha [Qh 6c]\r\nIPray2Buddha: calls 50\r\nkatarina1011: raises 300 to 400\r\nIPray2Buddha: folds \r\nUncalled bet (300) returned to katarina1011\r\nkatarina1011 collected 200 from pot\r\nkatarina1011: doesn't show hand \r\n*** SUMMARY ***\r\nTotal pot 200 | Rake 0 \r\nSeat 1: IPray2Buddha (button) (small blind) folded before Flop\r\nSeat 2: katarina1011 (big blind) collected (200)\r\n\r\nHand #50: \r\n\r\nPokerStars Hand #222089085253: Tournament #3091025143, $28.78+$1.22 USD Hold'em No Limit - Level VII (50/100) - 2021/01/01 9:11:22 ET\r\nTable '3091025143 1' 2-max Seat #2 is the button\r\nSeat 1: IPray2Buddha (1096 in chips) \r\nSeat 2: katarina1011 (1904 in chips) \r\nkatarina1011: posts small blind 50\r\nIPray2Buddha: posts big blind 100

\r\n*** HOLE CARDS ***\r\nDealt to IPray2Buddha [9c 4s]\r\nkatarina1011: calls 50\r\nIPray2Buddha: checks \r\n*** FLOP *** [9h Tc 4h]\r\nIPray2Buddha: checks \r\nkatarina1011: bets 100\r\nIPray2Buddha: raises 300 to 400\r\nkatarina1011: raises 1000 to 1400\r\nIPray2Buddha: calls 596 and is all-in\r\nUncalled bet (404) returned to katarina1011\r\n*** TURN *** [9h Tc 4h] [3c]\r\n*** RIVER *** [9h Tc 4h 3c] [Jc]\r\n*** SHOW DOWN ***\r\nIPray2Buddha: shows [9c 4s] (two pair, Nines and Fours)\r\nkatarina1011: shows [Td 9s] (two pair, Tens and Nines)\r\nkatarina1011 collected 2192 from pot\r\nIPray2Buddha finished the tournament in 2nd place\r\nkatarina1011 wins the tournament and receives $57.56 - congratulations!\r\n*** SUMMARY ***\r\nTotal pot 2192 | Rake 0 \r\nBoard [9h Tc 4h 3c Jc]\r\nSeat 1: IPray2Buddha (big blind) showed [9c 4s] and lost with two pair, Nines and Fours\r\nSeat 2: katarina1011 (button) (small blind) showed [Td 9s] and won (2192) with two pair, Tens and Nines\r\n\r\nHand #51: \r\n\r\nPokerStars Hand #222090442427: Tournament #3091070723, $28.57+$1.43 USD Hold'em No Limit - Level I (10/20) - 2021/01/01 10:03:22 ET\r\nTable '3091070723 1' 2-max Seat #1 is the button\r\nSeat 1: IPray2Buddha (1500 in chips) \r\nSeat 2: dariusz1979 (1500 in chips) \r\nIPray2Buddha: posts small blind 10\r\ndariusz1979: posts big blind 20

\r\n*** HOLE CARDS ***\r\nDealt to IPray2Buddha [Js 8s]\r\nIPray2Buddha: raises 30 to 50\r\ndariusz1979: folds \r\nUncalled bet (30) returned to IPray2Buddha\r\nIPray2Buddha collected 40 from pot\r\n*** SUMMARY ***\r\nTotal pot 40 | Rake 0 \r\nSeat 1: IPray2Buddha (button) (small blind) collected (40)\r\nSeat 2: dariusz1979 (big blind) folded before Flop\r\n\r\nHand #52: \r\n\r\nPokerStars Hand #222090453443: Tournament #3091070723, $28.57+$1.43 USD Hold'em No Limit - Level I (10/20) - 2021/01/01 10:03:45 ET\r\nTable '3091070723 1' 2-max Seat #2 is the button\r\nSeat 1: IPray2Buddha (1520 in chips) \r\nSeat 2: dariusz1979 (1480 in chips) \r\ndariusz1979: posts small blind 10\r\nIPray2Buddha: posts big blind 20

\r\n*** HOLE CARDS ***\r\nDealt to IPray2Buddha [As 9d]\r\ndariusz1979: folds \r\nUncalled bet (10) returned to IPray2Buddha\r\nIPray2Buddha collected 20 from pot\r\n*** SUMMARY ***\r\nTotal pot 20 | Rake 0 \r\nSeat 1: IPray2Buddha (big blind) collected (20)\r\nSeat 2: dariusz1979 (button) (small blind) folded before Flop\r\n\r\nHand #53: \r\n\r\nPokerStars Hand #222090456427: Tournament #3091070723, $28.57+$1.43 USD Hold'em No Limit - Level I (10/20) - 2021/01/01 10:03:52 ET\r\nTable '3091070723 1' 2-max Seat #1 is the button\r\nSeat 1: IPray2Buddha (1530 in chips) \r\nSeat 2: dariusz1979 (1470 in chips) \r\nIPray2Buddha: posts small blind 10\r\ndariusz1979: posts big blind 20

\r\n*** HOLE CARDS ***\r\nDealt to IPray2Buddha [Ad Kh]\r\nIPray2Buddha: raises 30 to 50\r\ndariusz1979: folds \r\nUncalled bet (30) returned to IPray2Buddha\r\nIPray2Buddha collected 40 from pot\r\n*** SUMMARY ***\r\nTotal pot 40 | Rake 0 \r\nSeat 1: IPray2Buddha (button) (small blind) collected (40)\r\nSeat 2: dariusz1979 (big blind) folded before Flop\r\n\r\nHand #54: \r\n\r\nPokerStars Hand #222090460934: Tournament #3091070723, $28.57+$1.43 USD Hold'em No Limit - Level I (10/20) - 2021/01/01 10:04:02 ET\r\nTable '3091070723 1' 2-max Seat #2 is the button\r\nSeat 1: IPray2Buddha (1550 in chips) \r\nSeat 2: dariusz1979 (1450 in chips) \r\ndariusz1979: posts small blind 10\r\nIPray2Buddha: posts big blind 20

\r\n*** HOLE CARDS ***\r\nDealt to IPray2Buddha [Qc 8d]\r\ndariusz1979: folds \r\nUncalled bet (10) returned to IPray2Buddha\r\nIPray2Buddha collected 20 from pot\r\n*** SUMMARY ***\r\nTotal pot 20 | Rake 0 \r\nSeat 1: IPray2Buddha (big blind) collected (20)\r\nSeat 2: dariusz1979 (button) (small blind) folded before Flop\r\n\r\nHand #55: \r\n\r\nPokerStars Hand #222090466167: Tournament #3091070723, $28.57+$1.43 USD Hold'em No Limit - Level I (10/20) - 2021/01/01 10:04:13 ET\r\nTable '3091070723 1' 2-max Seat #1 is the button\r\nSeat 1: IPray2Buddha (1560 in chips) \r\nSeat 2: dariusz1979 (1440 in chips) \r\nIPray2Buddha: posts small blind 10\r\ndariusz1979: posts big blind 20

\r\n*** HOLE CARDS ***\r\nDealt to IPray2Buddha [Ac 6h]\r\nIPray2Buddha: raises 30 to 50\r\ndariusz1979: folds \r\nUncalled bet (30) returned to IPray2Buddha\r\nIPray2Buddha collected 40 from pot\r\n*** SUMMARY ***\r\nTotal pot 40 | Rake 0 \r\nSeat 1: IPray2Buddha (button) (small blind) collected (40)\r\nSeat 2: dariusz1979 (big blind) folded before Flop\r\n\r\nHand #56: \r\n\r\nPokerStars Hand #222090471677: Tournament #3091070723, $28.57+$1.43 USD Hold'em No Limit - Level I (10/20) - 2021/01/01 10:04:25 ET\r\nTable '3091070723 1' 2-max Seat #2 is the button\r\nSeat 1: IPray2Buddha (1580 in chips) \r\nSeat 2: dariusz1979 (1420 in chips) \r\ndariusz1979: posts small blind 10\r\nIPray2Buddha: posts big blind 20

\r\n*** HOLE CARDS ***\r\nDealt to IPray2Buddha [7c Td]\r\ndariusz1979: folds \r\nUncalled bet (10) returned to IPray2Buddha\r\nIPray2Buddha collected 20 from pot\r\n*** SUMMARY ***\r\nTotal pot 20 | Rake 0 \r\nSeat 1: IPray2Buddha (big blind) collected (20)\r\nSeat 2: dariusz1979 (button) (small blind) folded before Flop\r\n\r\nHand #57: \r\n\r\nPokerStars Hand #222090475679: Tournament #3091070723, $28.57+$1.43 USD Hold'em No Limit - Level I (10/20) - 2021/01/01 10:04:33 ET\r\nTable '3091070723 1' 2-max Seat #1 is the button\r\nSeat 1: IPray2Buddha (1590 in chips) \r\nSeat 2: dariusz1979 (1410 in chips) \r\nIPray2Buddha: posts small blind 10\r\ndariusz1979: posts big blind 20

\r\n*** HOLE CARDS ***\r\nDealt to IPray2Buddha [4d 9s]\r\nIPray2Buddha: calls 10\r\ndariusz1979: checks \r\n*** FLOP *** [3h 6c Kd]\r\ndariusz1979: checks \r\nIPray2Buddha: checks \r\n*** TURN *** [3h 6c Kd] [Ah]\r\ndariusz1979: checks \r\nIPray2Buddha: bets 20\r\ndariusz1979: folds \r\nUncalled bet (20) returned to IPray2Buddha\r\nIPray2Buddha collected 40 from pot\r\n*** SUMMARY ***\r\nTotal pot 40 | Rake 0 \r\nBoard [3h 6c Kd Ah]\r\nSeat 1: IPray2Buddha (button) (small blind) collected (40)\r\nSeat 2: dariusz1979 (big blind) folded on the Turn\r\n\r\nHand #58: \r\n\r\nPokerStars Hand #222090492232: Tournament #3091070723, $28.57+$1.43 USD Hold'em No Limit - Level I (10/20) - 2021/01/01 10:05:08 ET\r\nTable '3091070723 1' 2-max Seat #2 is the button\r\nSeat 1: IPray2Buddha (1610 in chips) \r\nSeat 2: dariusz1979 (1390 in chips) \r\ndariusz1979: posts small blind 10\r\nIPray2Buddha: posts big blind 20

\r\n*** HOLE CARDS ***\r\nDealt to IPray2Buddha [3d 9d]\r\ndariusz1979: raises 20 to 40\r\nIPray2Buddha: calls 20\r\n*** FLOP *** [9c 3c 5h]\r\nIPray2Buddha: checks \r\ndariusz1979: checks \r\n*** TURN *** [9c 3c 5h] [3h]\r\nIPray2Buddha: checks \r\ndariusz1979: checks \r\n*** RIVER *** [9c 3c 5h 3h] [Kh]\r\nIPray2Buddha: checks \r\ndariusz1979: bets 40\r\nIPray2Buddha: raises 1530 to 1570 and is all-in\r\ndariusz1979: folds \r\nUncalled bet (1530) returned to IPray2Buddha\r\nIPray2Buddha collected 160 from pot\r\n*** SUMMARY ***\r\nTotal pot 160 | Rake 0 \r\nBoard [9c 3c 5h 3h Kh]\r\nSeat 1: IPray2Buddha (big blind) collected (160)\r\nSeat 2: dariusz1979 (button) (small blind) folded on the River\r\n\r\nHand #59: \r\n\r\nPokerStars Hand #222090525214: Tournament #3091070723, $28.57+$1.43 USD Hold'em No Limit - Level I (10/20) - 2021/01/01 10:06:19 ET\r\nTable '3091070723 1' 2-max Seat #1 is the button\r\nSeat 1: IPray2Buddha (1690 in chips) \r\nSeat 2: dariusz1979 (1310 in chips) \r\nIPray2Buddha: posts small blind 10\r\ndariusz1979: posts big blind 20

\r\n*** HOLE CARDS ***\r\nDealt to IPray2Buddha [5h Kd]\r\nIPray2Buddha: raises 30 to 50\r\ndariusz1979: calls 30\r\n*** FLOP *** [4d 6h 9c]\r\ndariusz1979: checks \r\nIPray2Buddha: checks \r\n*** TURN *** [4d 6h 9c] [8h]\r\ndariusz1979: checks \r\nIPray2Buddha: checks \r\n*** RIVER *** [4d 6h 9c 8h] [8d]\r\ndariusz1979: checks \r\nIPray2Buddha: checks \r\n*** SHOW DOWN ***\r\ndariusz1979: shows [Tc Qh] (a pair of Eights)\r\nIPray2Buddha: shows [5h Kd] (a pair of Eights - King kicker)\r\nIPray2Buddha collected 100 from pot\r\n*** SUMMARY ***\r\nTotal pot 100 | Rake 0 \r\nBoard [4d 6h 9c 8h 8d]\r\nSeat 1: IPray2Buddha (button) (small blind) showed [5h Kd] and won (100) with a pair of Eights\r\nSeat 2: dariusz1979 (big blind) showed [Tc Qh] and lost with a pair of Eights\r\n\r\nHand #60: \r\n\r\nPokerStars Hand #222090546490: Tournament #3091070723, $28.57+$1.43 USD Hold'em No Limit - Level I (10/20) - 2021/01/01 10:07:04 ET\r\nTable '3091070723 1' 2-max Seat #2 is the button\r\nSeat 1: IPray2Buddha (1740 in chips) \r\nSeat 2: dariusz1979 (1260 in chips) \r\ndariusz1979: posts small blind 10\r\nIPray2Buddha: posts big blind 20

\r\n*** HOLE CARDS ***\r\nDealt to IPray2Buddha [Qd 6c]\r\ndariusz1979: folds \r\nUncalled bet (10) returned to IPray2Buddha\r\nIPray2Buddha collected 20 from pot\r\n*** SUMMARY ***\r\nTotal pot 20 | Rake 0 \r\nSeat 1: IPray2Buddha (big blind) collected (20)\r\nSeat 2: dariusz1979 (button) (small blind) folded before Flop\r\n\r\nHand #61: \r\n\r\nPokerStars Hand #222090549671: Tournament #3091070723, $28.57+$1.43 USD Hold'em No Limit - Level I (10/20) - 2021/01/01 10:07:11 ET\r\nTable '3091070723 1' 2-max Seat #1 is the button\r\nSeat 1: IPray2Buddha (1750 in chips) \r\nSeat 2: dariusz1979 (1250 in chips) \r\nIPray2Buddha: posts small blind 10\r\ndariusz1979: posts big blind 20

\r\n*** HOLE CARDS ***\r\nDealt to IPray2Buddha [7d 5s]\r\nIPray2Buddha: raises 30 to 50\r\ndariusz1979: folds \r\nUncalled bet (30) returned to IPray2Buddha\r\nIPray2Buddha collected 40 from pot\r\n*** SUMMARY ***\r\nTotal pot 40 | Rake 0 \r\nSeat 1: IPray2Buddha (button) (small blind) collected (40)\r\nSeat 2: dariusz1979 (big blind) folded before Flop\r\n\r\nHand #62: \r\n\r\nPokerStars Hand #222090557265: Tournament #3091070723, $28.57+$1.43 USD Hold'em No Limit - Level I (10/20) - 2021/01/01 10:07:27 ET\r\nTable '3091070723 1' 2-max Seat #2 is the button\r\nSeat 1: IPray2Buddha (1770 in chips) \r\nSeat 2: dariusz1979 (1230 in chips) \r\ndariusz1979: posts small blind 10\r\nIPray2Buddha: posts big blind 20


\r\n*** HOLE CARDS ***\r\nDealt to IPray2Buddha [Jd Ah]\r\ndariusz1979: folds \r\nUncalled bet (10) returned to IPray2Buddha\r\nIPray2Buddha collected 20 from pot\r\n*** SUMMARY ***\r\nTotal pot 20 | Rake 0 \r\nSeat 1: IPray2Buddha (big blind) collected (20)\r\nSeat 2: dariusz1979 (button) (small blind) folded before Flop\r\n\r\nHand #63: \r\n\r\nPokerStars Hand #222090560269: Tournament #3091070723, $28.57+$1.43 USD Hold'em No Limit - Level I (10/20) - 2021/01/01 10:07:34 ET\r\nTable '3091070723 1' 2-max Seat #1 is the button\r\nSeat 1: IPray2Buddha (1780 in chips) \r\nSeat 2: dariusz1979 (1220 in chips) \r\nIPray2Buddha: posts small blind 10\r\ndariusz1979: posts big blind 20


\r\n*** HOLE CARDS ***\r\nDealt to IPray2Buddha [2s 2d]\r\nIPray2Buddha: raises 30 to 50\r\ndariusz1979: folds \r\nUncalled bet (30) returned to IPray2Buddha\r\nIPray2Buddha collected 40 from pot\r\n*** SUMMARY ***\r\nTotal pot 40 | Rake 0 \r\nSeat 1: IPray2Buddha (button) (small blind) collected (40)\r\nSeat 2: dariusz1979 (big blind) folded before Flop\r\n\r\nHand #64: \r\n\r\nPokerStars Hand #222090568416: Tournament #3091070723, $28.57+$1.43 USD Hold'em No Limit - Level I (10/20) - 2021/01/01 10:07:51 ET\r\nTable '3091070723 1' 2-max Seat #2 is the button\r\nSeat 1: IPray2Buddha (1800 in chips) \r\nSeat 2: dariusz1979 (1200 in chips) \r\ndariusz1979: posts small blind 10\r\nIPray2Buddha: posts big blind 20

\r\n*** HOLE CARDS ***\r\nDealt to IPray2Buddha [Kd 3s]\r\ndariusz1979: raises 20 to 40\r\nIPray2Buddha: folds \r\nUncalled bet (20) returned to dariusz1979\r\ndariusz1979 collected 40 from pot\r\ndariusz1979: doesn't show hand \r\n*** SUMMARY ***\r\nTotal pot 40 | Rake 0 \r\nSeat 1: IPray2Buddha (big blind) folded before Flop\r\nSeat 2: dariusz1979 (button) (small blind) collected (40)\r\n\r\nHand #65: \r\n\r\nPokerStars Hand #222090574937: Tournament #3091070723, $28.57+$1.43 USD Hold'em No Limit - Level I (10/20) - 2021/01/01 10:08:05 ET\r\nTable '3091070723 1' 2-max Seat #1 is the button\r\nSeat 1: IPray2Buddha (1780 in chips) \r\nSeat 2: dariusz1979 (1220 in chips) \r\nIPray2Buddha: posts small blind 10\r\ndariusz1979: posts big blind 20

\r\n*** HOLE CARDS ***\r\nDealt to IPray2Buddha [3d 2h]\r\nIPray2Buddha: calls 10\r\ndariusz1979: raises 80 to 100\r\nIPray2Buddha: folds \r\nUncalled bet (80) returned to dariusz1979\r\ndariusz1979 collected 40 from pot\r\ndariusz1979: doesn't show hand \r\n*** SUMMARY ***\r\nTotal pot 40 | Rake 0 \r\nSeat 1: IPray2Buddha (button) (small blind) folded before Flop\r\nSeat 2: dariusz1979 (big blind) collected (40)\r\n\r\nHand #66: \r\n\r\nPokerStars Hand #222090583614: Tournament #3091070723, $28.57+$1.43 USD Hold'em No Limit - Level I (10/20) - 2021/01/01 10:08:24 ET\r\nTable '3091070723 1' 2-max Seat #2 is the button\r\nSeat 1: IPray2Buddha (1760 in chips) \r\nSeat 2: dariusz1979 (1240 in chips) \r\ndariusz1979: posts small blind 10\r\nIPray2Buddha: posts big blind 20

\r\n*** HOLE CARDS ***\r\nDealt to IPray2Buddha [Ac 7c]\r\ndariusz1979: raises 20 to 40\r\nIPray2Buddha: calls 20\r\n*** FLOP *** [4s Js 2h]\r\nIPray2Buddha: checks \r\ndariusz1979: bets 40\r\nIPray2Buddha: folds \r\nUncalled bet (40) returned to dariusz1979\r\ndariusz1979 collected 80 from pot\r\ndariusz1979: doesn't show hand \r\n*** SUMMARY ***\r\nTotal pot 80 | Rake 0 \r\nBoard [4s Js 2h]\r\nSeat 1: IPray2Buddha (big blind) folded on the Flop\r\nSeat 2: dariusz1979 (button) (small blind) collected (80)\r\n\r\nHand #67: \r\n\r\nPokerStars Hand #222090595401: Tournament #3091070723, $28.57+$1.43 USD Hold'em No Limit - Level I (10/20) - 2021/01/01 10:08:49 ET\r\nTable '3091070723 1' 2-max Seat #1 is the button\r\nSeat 1: IPray2Buddha (1720 in chips) \r\nSeat 2: dariusz1979 (1280 in chips) \r\nIPray2Buddha: posts small blind 10\r\ndariusz1979: posts big blind 20

\r\n*** HOLE CARDS ***\r\nDealt to IPray2Buddha [2d Tc]\r\nIPray2Buddha: calls 10\r\ndariusz1979: raises 80 to 100\r\nIPray2Buddha: folds \r\nUncalled bet (80) returned to dariusz1979\r\ndariusz1979 collected 40 from pot\r\ndariusz1979: doesn't show hand \r\n*** SUMMARY ***\r\nTotal pot 40 | Rake 0 \r\nSeat 1: IPray2Buddha (button) (small blind) folded before Flop\r\nSeat 2: dariusz1979 (big blind) collected (40)\r\n\r\nHand #68: \r\n\r\nPokerStars Hand #222090605065: Tournament #3091070723, $28.57+$1.43 USD Hold'em No Limit - Level I (10/20) - 2021/01/01 10:09:10 ET\r\nTable '3091070723 1' 2-max Seat #2 is the button\r\nSeat 1: IPray2Buddha (1700 in chips) \r\nSeat 2: dariusz1979 (1300 in chips) \r\ndariusz1979: posts small blind 10\r\nIPray2Buddha: posts big blind 20


\r\n*** HOLE CARDS ***\r\nDealt to IPray2Buddha [Qc 7h]\r\ndariusz1979: raises 20 to 40\r\nIPray2Buddha: calls 20\r\n*** FLOP *** [5c 8h 4h]\r\nIPray2Buddha: checks \r\ndariusz1979: checks \r\n*** TURN *** [5c 8h 4h] [Tc]\r\nIPray2Buddha: bets 160\r\ndariusz1979: folds \r\nUncalled bet (160) returned to IPray2Buddha\r\nIPray2Buddha collected 80 from pot\r\n*** SUMMARY ***\r\nTotal pot 80 | Rake 0 \r\nBoard [5c 8h 4h Tc]\r\nSeat 1: IPray2Buddha (big blind) collected (80)\r\nSeat 2: dariusz1979 (button) (small blind) folded on the Turn\r\n\r\nHand #69: \r\n\r\nPokerStars Hand #222090621670: Tournament #3091070723, $28.57+$1.43 USD Hold'em No Limit - Level II (15/30) - 2021/01/01 10:09:45 ET\r\nTable '3091070723 1' 2-max Seat #1 is the button\r\nSeat 1: IPray2Buddha (1740 in chips) \r\nSeat 2: dariusz1979 (1260 in chips) \r\nIPray2Buddha: posts small blind 15\r\ndariusz1979: posts big blind 30


\r\n*** HOLE CARDS ***\r\nDealt to IPray2Buddha [Ad 3d]\r\nIPray2Buddha: calls 15\r\ndariusz1979: checks \r\n*** FLOP *** [9h 4h 4d]\r\ndariusz1979: checks \r\nIPray2Buddha: bets 30\r\ndariusz1979: calls 30\r\n*** TURN *** [9h 4h 4d] [2c]\r\ndariusz1979: checks \r\nIPray2Buddha: checks \r\n*** RIVER *** [9h 4h 4d 2c] [Ac]\r\ndariusz1979: checks \r\nIPray2Buddha: bets 90\r\ndariusz1979: calls 90\r\n*** SHOW DOWN ***\r\nIPray2Buddha: shows [Ad 3d] (two pair, Aces and Fours)\r\n \r\nIPray2Buddha collected 300 from pot\r\n*** SUMMARY ***\r\nTotal pot 300 | Rake 0 \r\nBoard [9h 4h 4d 2c Ac]\r\nSeat 1: IPray2Buddha (button) (small blind) showed [Ad 3d] and won (300) with two pair, Aces and Fours\r\nSeat 2: dariusz1979 (big blind) mucked [Ts 9c]\r\n\r\nHand #70: \r\n\r\nPokerStars Hand #222090651739: Tournament #3091070723, $28.57+$1.43 USD Hold'em No Limit - Level II (15/30) - 2021/01/01 10:10:48 ET\r\nTable '3091070723 1' 2-max Seat #2 is the button\r\nSeat 1: IPray2Buddha (1890 in chips) \r\nSeat 2: dariusz1979 (1110 in chips) \r\ndariusz1979: posts small blind 15\r\nIPray2Buddha: posts big blind 30


\r\n*** HOLE CARDS ***\r\nDealt to IPray2Buddha [Ts 7c]\r\ndariusz1979: folds \r\nUncalled bet (15) returned to IPray2Buddha\r\nIPray2Buddha collected 30 from pot\r\n*** SUMMARY ***\r\nTotal pot 30 | Rake 0 \r\nSeat 1: IPray2Buddha (big blind) collected (30)\r\nSeat 2: dariusz1979 (button) (small blind) folded before Flop\r\n\r\nHand #71: \r\n\r\nPokerStars Hand #222090654625: Tournament #3091070723, $28.57+$1.43 USD Hold'em No Limit - Level II (15/30) - 2021/01/01 10:10:54 ET\r\nTable '3091070723 1' 2-max Seat #1 is the button\r\nSeat 1: IPray2Buddha (1905 in chips) \r\nSeat 2: dariusz1979 (1095 in chips) \r\nIPray2Buddha: posts small blind 15\r\ndariusz1979: posts big blind 30


\r\n*** HOLE CARDS ***\r\nDealt to IPray2Buddha [Ks Th]\r\nIPray2Buddha: raises 33 to 63\r\ndariusz1979: calls 33\r\n*** FLOP *** [8c 9s 4d]\r\ndariusz1979: checks \r\nIPray2Buddha: checks \r\n*** TURN *** [8c 9s 4d] [4h]\r\ndariusz1979: bets 90\r\nIPray2Buddha: calls 90\r\n*** RIVER *** [8c 9s 4d 4h] [Ts]\r\ndariusz1979: checks \r\nIPray2Buddha: bets 230\r\ndariusz1979: folds \r\nUncalled bet (230) returned to IPray2Buddha\r\nIPray2Buddha collected 306 from pot\r\n*** SUMMARY ***\r\nTotal pot 306 | Rake 0 \r\nBoard [8c 9s 4d 4h Ts]\r\nSeat 1: IPray2Buddha (button) (small blind) collected (306)\r\nSeat 2: dariusz1979 (big blind) folded on the River\r\n\r\nHand #72: \r\n\r\nPokerStars Hand #222090672358: Tournament #3091070723, $28.57+$1.43 USD Hold'em No Limit - Level II (15/30) - 2021/01/01 10:11:32 ET\r\nTable '3091070723 1' 2-max Seat #2 is the button\r\nSeat 1: IPray2Buddha (2058 in chips) \r\nSeat 2: dariusz1979 (942 in chips) \r\ndariusz1979: posts small blind 15\r\nIPray2Buddha: posts big blind 30

\r\n*** HOLE CARDS ***\r\nDealt to IPray2Buddha [Th Ad]\r\ndariusz1979: calls 15\r\nIPray2Buddha: raises 75 to 105\r\ndariusz1979: folds \r\nUncalled bet (75) returned to IPray2Buddha\r\nIPray2Buddha collected 60 from pot\r\n*** SUMMARY ***\r\nTotal pot 60 | Rake 0 \r\nSeat 1: IPray2Buddha (big blind) collected (60)\r\nSeat 2: dariusz1979 (button) (small blind) folded before Flop\r\n\r\nHand #73: \r\n\r\nPokerStars Hand #222090685276: Tournament #3091070723, $28.57+$1.43 USD Hold'em No Limit - Level II (15/30) - 2021/01/01 10:11:59 ET\r\nTable '3091070723 1' 2-max Seat #1 is the button\r\nSeat 1: IPray2Buddha (2088 in chips) \r\nSeat 2: dariusz1979 (912 in chips) \r\nIPray2Buddha: posts small blind 15\r\ndariusz1979: posts big blind 30

\r\n*** HOLE CARDS ***\r\nDealt to IPray2Buddha [4d 3h]\r\nIPray2Buddha: calls 15\r\ndariusz1979: raises 90 to 120\r\nIPray2Buddha: folds \r\nUncalled bet (90) returned to dariusz1979\r\ndariusz1979 collected 60 from pot\r\ndariusz1979: doesn't show hand \r\n*** SUMMARY ***\r\nTotal pot 60 | Rake 0 \r\nSeat 1: IPray2Buddha (button) (small blind) folded before Flop\r\nSeat 2: dariusz1979 (big blind) collected (60)\r\n\r\nHand #74: \r\n\r\nPokerStars Hand #222090691267: Tournament #3091070723, $28.57+$1.43 USD Hold'em No Limit - Level II (15/30) - 2021/01/01 10:12:12 ET\r\nTable '3091070723 1' 2-max Seat #2 is the button\r\nSeat 1: IPray2Buddha (2058 in chips) \r\nSeat 2: dariusz1979 (942 in chips) \r\ndariusz1979: posts small blind 15\r\nIPray2Buddha: posts big blind 30

\r\n*** HOLE CARDS ***\r\nDealt to IPray2Buddha [3c Qc]\r\ndariusz1979: folds \r\nUncalled bet (15) returned to IPray2Buddha\r\nIPray2Buddha collected 30 from pot\r\n*** SUMMARY ***\r\nTotal pot 30 | Rake 0 \r\nSeat 1: IPray2Buddha (big blind) collected (30)\r\nSeat 2: dariusz1979 (button) (small blind) folded before Flop\r\n\r\nHand #75: \r\n\r\nPokerStars Hand #222090694651: Tournament #3091070723, $28.57+$1.43 USD Hold'em No Limit - Level II (15/30) - 2021/01/01 10:12:19 ET\r\nTable '3091070723 1' 2-max Seat #1 is the button\r\nSeat 1: IPray2Buddha (2073 in chips) \r\nSeat 2: dariusz1979 (927 in chips) \r\nIPray2Buddha: posts small blind 15\r\ndariusz1979: posts big blind 30


\r\n*** HOLE CARDS ***\r\nDealt to IPray2Buddha [7h 6h]\r\nIPray2Buddha: raises 33 to 63\r\ndariusz1979: calls 33\r\n*** FLOP *** [Jh 3s 6c]\r\ndariusz1979: checks \r\nIPray2Buddha: bets 95\r\ndariusz1979: folds \r\nUncalled bet (95) returned to IPray2Buddha\r\nIPray2Buddha collected 126 from pot\r\n*** SUMMARY ***\r\nTotal pot 126 | Rake 0 \r\nBoard [Jh 3s 6c]\r\nSeat 1: IPray2Buddha (button) (small blind) collected (126)\r\nSeat 2: dariusz1979 (big blind) folded on the Flop\r\n\r\nHand #76: \r\n\r\nPokerStars Hand #222090708900: Tournament #3091070723, $28.57+$1.43 USD Hold'em No Limit - Level II (15/30) - 2021/01/01 10:12:49 ET\r\nTable '3091070723 1' 2-max Seat #2 is the button\r\nSeat 1: IPray2Buddha (2136 in chips) \r\nSeat 2: dariusz1979 (864 in chips) \r\ndariusz1979: posts small blind 15\r\nIPray2Buddha: posts big blind 30

\r\n*** HOLE CARDS ***\r\nDealt to IPray2Buddha [4c Ts]\r\ndariusz1979: raises 30 to 60\r\nIPray2Buddha: folds \r\nUncalled bet (30) returned to dariusz1979\r\ndariusz1979 collected 60 from pot\r\ndariusz1979: doesn't show hand \r\n*** SUMMARY ***\r\nTotal pot 60 | Rake 0 \r\nSeat 1: IPray2Buddha (big blind) folded before Flop\r\nSeat 2: dariusz1979 (button) (small blind) collected (60)\r\n\r\nHand #77: \r\n\r\nPokerStars Hand #222090716994: Tournament #3091070723, $28.57+$1.43 USD Hold'em No Limit - Level II (15/30) - 2021/01/01 10:13:05 ET\r\nTable '3091070723 1' 2-max Seat #1 is the button\r\nSeat 1: IPray2Buddha (2106 in chips) \r\nSeat 2: dariusz1979 (894 in chips) \r\nIPray2Buddha: posts small blind 15\r\ndariusz1979: posts big blind 30

\r\n*** HOLE CARDS ***\r\nDealt to IPray2Buddha [6h 4c]\r\nIPray2Buddha: calls 15\r\ndariusz1979: checks \r\n*** FLOP *** [Qs 9h Kh]\r\ndariusz1979: checks \r\nIPray2Buddha: checks \r\n*** TURN *** [Qs 9h Kh] [7h]\r\ndariusz1979: bets 30\r\nIPray2Buddha: raises 90 to 120\r\ndariusz1979: calls 90\r\n*** RIVER *** [Qs 9h Kh 7h] [2c]\r\ndariusz1979: checks \r\nIPray2Buddha: bets 90\r\ndariusz1979: calls 90\r\n*** SHOW DOWN ***\r\nIPray2Buddha: shows [6h 4c] (high card King)\r\ndariusz1979: shows [8h Qd] (a pair of Queens)\r\ndariusz1979 collected 480 from pot\r\n*** SUMMARY ***\r\nTotal pot 480 | Rake 0 \r\nBoard [Qs 9h Kh 7h 2c]\r\nSeat 1: IPray2Buddha (button) (small blind) showed [6h 4c] and lost with high card King\r\nSeat 2: dariusz1979 (big blind) showed [8h Qd] and won (480) with a pair of Queens\r\n\r\nHand #78: \r\n\r\nPokerStars Hand #222090736848: Tournament #3091070723, $28.57+$1.43 USD Hold'em No Limit - Level II (15/30) - 2021/01/01 10:13:47 ET\r\nTable '3091070723 1' 2-max Seat #2 is the button\r\nSeat 1: IPray2Buddha (1866 in chips) \r\nSeat 2: dariusz1979 (1134 in chips) \r\ndariusz1979: posts small blind 15\r\nIPray2Buddha: posts big blind 30

\r\n*** HOLE CARDS ***\r\nDealt to IPray2Buddha [Ah Th]\r\ndariusz1979: raises 30 to 60\r\nIPray2Buddha: raises 120 to 180\r\ndariusz1979: folds \r\nUncalled bet (120) returned to IPray2Buddha\r\nIPray2Buddha collected 120 from pot\r\n*** SUMMARY ***\r\nTotal pot 120 | Rake 0 \r\nSeat 1: IPray2Buddha (big blind) collected (120)\r\nSeat 2: dariusz1979 (button) (small blind) folded before Flop\r\n\r\nHand #79: \r\n\r\nPokerStars Hand #222090745869: Tournament #3091070723, $28.57+$1.43 USD Hold'em No Limit - Level II (15/30) - 2021/01/01 10:14:06 ET\r\nTable '3091070723 1' 2-max Seat #1 is the button\r\nSeat 1: IPray2Buddha (1926 in chips) \r\nSeat 2: dariusz1979 (1074 in chips) \r\nIPray2Buddha: posts small blind 15\r\ndariusz1979: posts big blind 30

\r\n*** HOLE CARDS ***\r\nDealt to IPray2Buddha [4h 5c]\r\nIPray2Buddha: raises 33 to 63\r\ndariusz1979: folds \r\nUncalled bet (33) returned to IPray2Buddha\r\nIPray2Buddha collected 60 from pot\r\n*** SUMMARY ***\r\nTotal pot 60 | Rake 0 \r\nSeat 1: IPray2Buddha (button) (small blind) collected (60)\r\nSeat 2: dariusz1979 (big blind) folded before Flop\r\n\r\nHand #80: \r\n\r\nPokerStars Hand #222090757179: Tournament #3091070723, $28.57+$1.43 USD Hold'em No Limit - Level II (15/30) - 2021/01/01 10:14:29 ET\r\nTable '3091070723 1' 2-max Seat #2 is the button\r\nSeat 1: IPray2Buddha (1956 in chips) \r\nSeat 2: dariusz1979 (1044 in chips) \r\ndariusz1979: posts small blind 15\r\nIPray2Buddha: posts big blind 30

\r\n*** HOLE CARDS ***\r\nDealt to IPray2Buddha [4d 8h]\r\ndariusz1979: raises 30 to 60\r\nIPray2Buddha: folds \r\nUncalled bet (30) returned to dariusz1979\r\ndariusz1979 collected 60 from pot\r\ndariusz1979: doesn't show hand \r\n*** SUMMARY ***\r\nTotal pot 60 | Rake 0 \r\nSeat 1: IPray2Buddha (big blind) folded before Flop\r\nSeat 2: dariusz1979 (button) (small blind) collected (60)\r\n\r\nHand #81: \r\n\r\nPokerStars Hand #222090769739: Tournament #3091070723, $28.57+$1.43 USD Hold'em No Limit - Level II (15/30) - 2021/01/01 10:14:52 ET\r\nTable '3091070723 1' 2-max Seat #1 is the button\r\nSeat 1: IPray2Buddha (1926 in chips) \r\nSeat 2: dariusz1979 (1074 in chips) \r\nIPray2Buddha: posts small blind 15\r\ndariusz1979: posts big blind 30

\r\n*** HOLE CARDS ***\r\nDealt to IPray2Buddha [Qs Th]\r\nIPray2Buddha: raises 33 to 63\r\ndariusz1979: folds \r\nUncalled bet (33) returned to IPray2Buddha\r\nIPray2Buddha collected 60 from pot\r\n*** SUMMARY ***\r\nTotal pot 60 | Rake 0 \r\nSeat 1: IPray2Buddha (button) (small blind) collected (60)\r\nSeat 2: dariusz1979 (big blind) folded before Flop\r\n\r\nHand #82: \r\n\r\nPokerStars Hand #222090776523: Tournament #3091070723, $28.57+$1.43 USD Hold'em No Limit - Level II (15/30) - 2021/01/01 10:15:06 ET\r\nTable '3091070723 1' 2-max Seat #2 is the button\r\nSeat 1: IPray2Buddha (1956 in chips) \r\nSeat 2: dariusz1979 (1044 in chips) \r\ndariusz1979: posts small blind 15\r\nIPray2Buddha: posts big blind 30

\r\n*** HOLE CARDS ***\r\nDealt to IPray2Buddha [2d Qh]\r\ndariusz1979: calls 15\r\nIPray2Buddha: checks \r\n*** FLOP *** [6h 6d 9h]\r\nIPray2Buddha: checks \r\ndariusz1979: bets 30\r\nIPray2Buddha: folds \r\nUncalled bet (30) returned to dariusz1979\r\ndariusz1979 collected 60 from pot\r\ndariusz1979: doesn't show hand \r\n*** SUMMARY ***\r\nTotal pot 60 | Rake 0 \r\nBoard [6h 6d 9h]\r\nSeat 1: IPray2Buddha (big blind) folded on the Flop\r\nSeat 2: dariusz1979 (button) (small blind) collected (60)\r\n\r\nHand #83: \r\n\r\nPokerStars Hand #222090793514: Tournament #3091070723, $28.57+$1.43 USD Hold'em No Limit - Level III (20/40) - 2021/01/01 10:15:39 ET\r\nTable '3091070723 1' 2-max Seat #1 is the button\r\nSeat 1: IPray2Buddha (1926 in chips) \r\nSeat 2: dariusz1979 (1074 in chips) \r\nIPray2Buddha: posts small blind 20\r\ndariusz1979: posts big blind 40

\r\n*** HOLE CARDS ***\r\nDealt to IPray2Buddha [Ts Qs]\r\nIPray2Buddha: calls 20\r\ndariusz1979: checks \r\n*** FLOP *** [Tc 8h 3h]\r\ndariusz1979: checks \r\nIPray2Buddha: bets 60\r\ndariusz1979: folds \r\nUncalled bet (60) returned to IPray2Buddha\r\nIPray2Buddha collected 80 from pot\r\n*** SUMMARY ***\r\nTotal pot 80 | Rake 0 \r\nBoard [Tc 8h 3h]\r\nSeat 1: IPray2Buddha (button) (small blind) collected (80)\r\nSeat 2: dariusz1979 (big blind) folded on the Flop\r\n\r\nHand #84: \r\n\r\nPokerStars Hand #222090813097: Tournament #3091070723, $28.57+$1.43 USD Hold'em No Limit - Level III (20/40) - 2021/01/01 10:16:20 ET\r\nTable '3091070723 1' 2-max Seat #2 is the button\r\nSeat 1: IPray2Buddha (1966 in chips) \r\nSeat 2: dariusz1979 (1034 in chips) \r\ndariusz1979: posts small blind 20\r\nIPray2Buddha: posts big blind 40

\r\n*** HOLE CARDS ***\r\nDealt to IPray2Buddha [Ks 9s]\r\ndariusz1979: folds \r\nUncalled bet (20) returned to IPray2Buddha\r\nIPray2Buddha collected 40 from pot\r\n*** SUMMARY ***\r\nTotal pot 40 | Rake 0 \r\nSeat 1: IPray2Buddha (big blind) collected (40)\r\nSeat 2: dariusz1979 (button) (small blind) folded before Flop\r\n\r\nHand #85: \r\n\r\nPokerStars Hand #222090816160: Tournament #3091070723, $28.57+$1.43 USD Hold'em No Limit - Level III (20/40) - 2021/01/01 10:16:26 ET\r\nTable '3091070723 1' 2-max Seat #1 is the button\r\nSeat 1: IPray2Buddha (1986 in chips) \r\nSeat 2: dariusz1979 (1014 in chips) \r\nIPray2Buddha: posts small blind 20\r\ndariusz1979: posts big blind 40

\r\n*** HOLE CARDS ***\r\nDealt to IPray2Buddha [8s Qd]\r\nIPray2Buddha: raises 40 to 80\r\ndariusz1979: folds \r\nUncalled bet (40) returned to IPray2Buddha\r\nIPray2Buddha collected 80 from pot\r\n*** SUMMARY ***\r\nTotal pot 80 | Rake 0 \r\nSeat 1: IPray2Buddha (button) (small blind) collected (80)\r\nSeat 2: dariusz1979 (big blind) folded before Flop\r\n\r\nHand #86: \r\n\r\nPokerStars Hand #222090823612: Tournament #3091070723, $28.57+$1.43 USD Hold'em No Limit - Level III (20/40) - 2021/01/01 10:16:42 ET\r\nTable '3091070723 1' 2-max Seat #2 is the button\r\nSeat 1: IPray2Buddha (2026 in chips) \r\nSeat 2: dariusz1979 (974 in chips) \r\ndariusz1979: posts small blind 20\r\nIPray2Buddha: posts big blind 40

\r\n*** HOLE CARDS ***\r\nDealt to IPray2Buddha [Th Js]\r\ndariusz1979: folds \r\nUncalled bet (20) returned to IPray2Buddha\r\nIPray2Buddha collected 40 from pot\r\n*** SUMMARY ***\r\nTotal pot 40 | Rake 0 \r\nSeat 1: IPray2Buddha (big blind) collected (40)\r\nSeat 2: dariusz1979 (button) (small blind) folded before Flop\r\n\r\nHand #87: \r\n\r\nPokerStars Hand #222090826735: Tournament #3091070723, $28.57+$1.43 USD Hold'em No Limit - Level III (20/40) - 2021/01/01 10:16:48 ET\r\nTable '3091070723 1' 2-max Seat #1 is the button\r\nSeat 1: IPray2Buddha (2046 in chips) \r\nSeat 2: dariusz1979 (954 in chips) \r\nIPray2Buddha: posts small blind 20\r\ndariusz1979: posts big blind 40

\r\n*** HOLE CARDS ***\r\nDealt to IPray2Buddha [As 6h]\r\nIPray2Buddha: calls 20\r\ndariusz1979: checks \r\n*** FLOP *** [Ah Jd 7c]\r\ndariusz1979: checks \r\nIPray2Buddha: bets 40\r\ndariusz1979: calls 40\r\n*** TURN *** [Ah Jd 7c] [3d]\r\ndariusz1979: checks \r\nIPray2Buddha: bets 120\r\ndariusz1979: folds \r\nUncalled bet (120) returned to IPray2Buddha\r\nIPray2Buddha collected 160 from pot\r\n*** SUMMARY ***\r\nTotal pot 160 | Rake 0 \r\nBoard [Ah Jd 7c 3d]\r\nSeat 1: IPray2Buddha (button) (small blind) collected (160)\r\nSeat 2: dariusz1979 (big blind) folded on the Turn\r\n\r\nHand #88: \r\n\r\nPokerStars Hand #222090844731: Tournament #3091070723, $28.57+$1.43 USD Hold'em No Limit - Level III (20/40) - 2021/01/01 10:17:25 ET\r\nTable '3091070723 1' 2-max Seat #2 is the button\r\nSeat 1: IPray2Buddha (2126 in chips) \r\nSeat 2: dariusz1979 (874 in chips) \r\ndariusz1979: posts small blind 20\r\nIPray2Buddha: posts big blind 40


\r\n*** HOLE CARDS ***\r\nDealt to IPray2Buddha [5s 2c]\r\ndariusz1979: folds \r\nUncalled bet (20) returned to IPray2Buddha\r\nIPray2Buddha collected 40 from pot\r\n*** SUMMARY ***\r\nTotal pot 40 | Rake 0 \r\nSeat 1: IPray2Buddha (big blind) collected (40)\r\nSeat 2: dariusz1979 (button) (small blind) folded before Flop\r\n\r\nHand #89: \r\n\r\nPokerStars Hand #222090847798: Tournament #3091070723, $28.57+$1.43 USD Hold'em No Limit - Level III (20/40) - 2021/01/01 10:17:31 ET\r\nTable '3091070723 1' 2-max Seat #1 is the button\r\nSeat 1: IPray2Buddha (2146 in chips) \r\nSeat 2: dariusz1979 (854 in chips) \r\nIPray2Buddha: posts small blind 20\r\ndariusz1979: posts big blind 40


\r\n*** HOLE CARDS ***\r\nDealt to IPray2Buddha [5s 8d]\r\nIPray2Buddha: raises 40 to 80\r\ndariusz1979: folds \r\nUncalled bet (40) returned to IPray2Buddha\r\nIPray2Buddha collected 80 from pot\r\n*** SUMMARY ***\r\nTotal pot 80 | Rake 0 \r\nSeat 1: IPray2Buddha (button) (small blind) collected (80)\r\nSeat 2: dariusz1979 (big blind) folded before Flop\r\n\r\nHand #90: \r\n\r\nPokerStars Hand #222090853044: Tournament #3091070723, $28.57+$1.43 USD Hold'em No Limit - Level III (20/40) - 2021/01/01 10:17:42 ET\r\nTable '3091070723 1' 2-max Seat #2 is the button\r\nSeat 1: IPray2Buddha (2186 in chips) \r\nSeat 2: dariusz1979 (814 in chips) \r\ndariusz1979: posts small blind 20\r\nIPray2Buddha: posts big blind 40

\r\n*** HOLE CARDS ***\r\nDealt to IPray2Buddha [5h 2s]\r\ndariusz1979: raises 40 to 80\r\nIPray2Buddha: folds \r\nUncalled bet (40) returned to dariusz1979\r\ndariusz1979 collected 80 from pot\r\ndariusz1979: doesn't show hand \r\n*** SUMMARY ***\r\nTotal pot 80 | Rake 0 \r\nSeat 1: IPray2Buddha (big blind) folded before Flop\r\nSeat 2: dariusz1979 (button) (small blind) collected (80)\r\n\r\nHand #91: \r\n\r\nPokerStars Hand #222090858969: Tournament #3091070723, $28.57+$1.43 USD Hold'em No Limit - Level III (20/40) - 2021/01/01 10:17:54 ET\r\nTable '3091070723 1' 2-max Seat #1 is the button\r\nSeat 1: IPray2Buddha (2146 in chips) \r\nSeat 2: dariusz1979 (854 in chips) \r\nIPray2Buddha: posts small blind 20\r\ndariusz1979: posts big blind 40

\r\n*** HOLE CARDS ***\r\nDealt to IPray2Buddha [4s 9c]\r\nIPray2Buddha: calls 20\r\ndariusz1979: checks \r\n*** FLOP *** [Qd 9h Ad]\r\ndariusz1979: checks \r\nIPray2Buddha: checks \r\n*** TURN *** [Qd 9h Ad] [5c]\r\ndariusz1979: checks \r\nIPray2Buddha: checks \r\n*** RIVER *** [Qd 9h Ad 5c] [2h]\r\ndariusz1979: checks \r\nIPray2Buddha: bets 40\r\ndariusz1979: folds \r\nUncalled bet (40) returned to IPray2Buddha\r\nIPray2Buddha collected 80 from pot\r\n*** SUMMARY ***\r\nTotal pot 80 | Rake 0 \r\nBoard [Qd 9h Ad 5c 2h]\r\nSeat 1: IPray2Buddha (button) (small blind) collected (80)\r\nSeat 2: dariusz1979 (big blind) folded on the River\r\n\r\nHand #92: \r\n\r\nPokerStars Hand #222090889380: Tournament #3091070723, $28.57+$1.43 USD Hold'em No Limit - Level III (20/40) - 2021/01/01 10:18:57 ET\r\nTable '3091070723 1' 2-max Seat #2 is the button\r\nSeat 1: IPray2Buddha (2186 in chips) \r\nSeat 2: dariusz1979 (814 in chips) \r\ndariusz1979: posts small blind 20\r\nIPray2Buddha: posts big blind 40

\r\n*** HOLE CARDS ***\r\nDealt to IPray2Buddha [Qh Ks]\r\ndariusz1979: folds \r\nUncalled bet (20) returned to IPray2Buddha\r\nIPray2Buddha collected 40 from pot\r\n*** SUMMARY ***\r\nTotal pot 40 | Rake 0 \r\nSeat 1: IPray2Buddha (big blind) collected (40)\r\nSeat 2: dariusz1979 (button) (small blind) folded before Flop\r\n\r\nHand #93: \r\n\r\nPokerStars Hand #222090892514: Tournament #3091070723, $28.57+$1.43 USD Hold'em No Limit - Level III (20/40) - 2021/01/01 10:19:03 ET\r\nTable '3091070723 1' 2-max Seat #1 is the button\r\nSeat 1: IPray2Buddha (2206 in chips) \r\nSeat 2: dariusz1979 (794 in chips) \r\nIPray2Buddha: posts small blind 20\r\ndariusz1979: posts big blind 40

\r\n*** HOLE CARDS ***\r\nDealt to IPray2Buddha [3d 9s]\r\nIPray2Buddha: calls 20\r\ndariusz1979: checks \r\n*** FLOP *** [Jh 6c 4c]\r\ndariusz1979: checks \r\nIPray2Buddha: checks \r\n*** TURN *** [Jh 6c 4c] [Kc]\r\ndariusz1979: checks \r\nIPray2Buddha: checks \r\n*** RIVER *** [Jh 6c 4c Kc] [Ks]\r\ndariusz1979: checks \r\nIPray2Buddha: checks \r\n*** SHOW DOWN ***\r\ndariusz1979: shows [Qd 3c] (a pair of Kings)\r\n \r\ndariusz1979 collected 80 from pot\r\n*** SUMMARY ***\r\nTotal pot 80 | Rake 0 \r\nBoard [Jh 6c 4c Kc Ks]\r\nSeat 1: IPray2Buddha (button) (small blind) mucked [3d 9s]\r\nSeat 2: dariusz1979 (big blind) showed [Qd 3c] and won (80) with a pair of Kings\r\n\r\nHand #94: \r\n\r\nPokerStars Hand #222090919746: Tournament #3091070723, $28.57+$1.43 USD Hold'em No Limit - Level III (20/40) - 2021/01/01 10:19:59 ET\r\nTable '3091070723 1' 2-max Seat #2 is the button\r\nSeat 1: IPray2Buddha (2166 in chips) \r\nSeat 2: dariusz1979 (834 in chips) \r\ndariusz1979: posts small blind 20\r\nIPray2Buddha: posts big blind 40

\r\n*** HOLE CARDS ***\r\nDealt to IPray2Buddha [Ks 8d]\r\ndariusz1979: calls 20\r\nIPray2Buddha: raises 60 to 100\r\ndariusz1979: calls 60\r\n*** FLOP *** [8c 6h Jd]\r\nIPray2Buddha: checks \r\ndariusz1979: checks \r\n*** TURN *** [8c 6h Jd] [Jh]\r\nIPray2Buddha: bets 150\r\ndariusz1979: folds \r\nUncalled bet (150) returned to IPray2Buddha\r\nIPray2Buddha collected 200 from pot\r\n*** SUMMARY ***\r\nTotal pot 200 | Rake 0 \r\nBoard [8c 6h Jd Jh]\r\nSeat 1: IPray2Buddha (big blind) collected (200)\r\nSeat 2: dariusz1979 (button) (small blind) folded on the Turn\r\n\r\nHand #95: \r\n\r\nPokerStars Hand #222090945972: Tournament #3091070723, $28.57+$1.43 USD Hold'em No Limit - Level III (20/40) - 2021/01/01 10:20:53 ET\r\nTable '3091070723 1' 2-max Seat #1 is the button\r\nSeat 1: IPray2Buddha (2266 in chips) \r\nSeat 2: dariusz1979 (734 in chips) \r\nIPray2Buddha: posts small blind 20\r\ndariusz1979: posts big blind 40

\r\n*** HOLE CARDS ***\r\nDealt to IPray2Buddha [9c 4d]\r\nIPray2Buddha: raises 40 to 80\r\ndariusz1979: folds \r\nUncalled bet (40) returned to IPray2Buddha\r\nIPray2Buddha collected 80 from pot\r\n*** SUMMARY ***\r\nTotal pot 80 | Rake 0 \r\nSeat 1: IPray2Buddha (button) (small blind) collected (80)\r\nSeat 2: dariusz1979 (big blind) folded before Flop\r\n\r\nHand #96: \r\n\r\nPokerStars Hand #222090951417: Tournament #3091070723, $28.57+$1.43 USD Hold'em No Limit - Level III (20/40) - 2021/01/01 10:21:04 ET\r\nTable '3091070723 1' 2-max Seat #2 is the button\r\nSeat 1: IPray2Buddha (2306 in chips) \r\nSeat 2: dariusz1979 (694 in chips) \r\ndariusz1979: posts small blind 20\r\nIPray2Buddha: posts big blind 40

\r\n*** HOLE CARDS ***\r\nDealt to IPray2Buddha [9s 2d]\r\ndariusz1979: folds \r\nUncalled bet (20) returned to IPray2Buddha\r\nIPray2Buddha collected 40 from pot\r\n*** SUMMARY ***\r\nTotal pot 40 | Rake 0 \r\nSeat 1: IPray2Buddha (big blind) collected (40)\r\nSeat 2: dariusz1979 (button) (small blind) folded before Flop\r\n\r\nHand #97: \r\n\r\nPokerStars Hand #222090954604: Tournament #3091070723, $28.57+$1.43 USD Hold'em No Limit - Level III (20/40) - 2021/01/01 10:21:11 ET\r\nTable '3091070723 1' 2-max Seat #1 is the button\r\nSeat 1: IPray2Buddha (2326 in chips) \r\nSeat 2: dariusz1979 (674 in chips) \r\nIPray2Buddha: posts small blind 20\r\ndariusz1979: posts big blind 40

\r\n*** HOLE CARDS ***\r\nDealt to IPray2Buddha [2s Ks]\r\nIPray2Buddha: raises 40 to 80\r\ndariusz1979: calls 40\r\n*** FLOP *** [4h 3c 2d]\r\ndariusz1979: checks \r\nIPray2Buddha: bets 48\r\ndariusz1979: calls 48\r\n*** TURN *** [4h 3c 2d] [Ah]\r\ndariusz1979: checks \r\nIPray2Buddha: checks \r\n*** RIVER *** [4h 3c 2d Ah] [Qs]\r\ndariusz1979: checks \r\nIPray2Buddha: checks \r\n*** SHOW DOWN ***\r\ndariusz1979: shows [Kd Js] (high card Ace)\r\nIPray2Buddha: shows [2s Ks] (a pair of Deuces)\r\nIPray2Buddha collected 256 from pot\r\n*** SUMMARY ***\r\nTotal pot 256 | Rake 0 \r\nBoard [4h 3c 2d Ah Qs]\r\nSeat 1: IPray2Buddha (button) (small blind) showed [2s Ks] and won (256) with a pair of Deuces\r\nSeat 2: dariusz1979 (big blind) showed [Kd Js] and lost with high card Ace\r\n\r\nHand #98: \r\n\r\nPokerStars Hand #222090984671: Tournament #3091070723, $28.57+$1.43 USD Hold'em No Limit - Level IV (25/50) - 2021/01/01 10:22:00 ET\r\nTable '3091070723 1' 2-max Seat #2 is the button\r\nSeat 1: IPray2Buddha (2454 in chips) \r\nSeat 2: dariusz1979 (546 in chips) \r\ndariusz1979: posts small blind 25\r\nIPray2Buddha: posts big blind 50

\r\n*** HOLE CARDS ***\r\nDealt to IPray2Buddha [5h 8h]\r\ndariusz1979: raises 496 to 546 and is all-in\r\nIPray2Buddha: folds \r\nUncalled bet (496) returned to dariusz1979\r\ndariusz1979 collected 100 from pot\r\ndariusz1979: doesn't show hand \r\n*** SUMMARY ***\r\nTotal pot 100 | Rake 0 \r\nSeat 1: IPray2Buddha (big blind) folded before Flop\r\nSeat 2: dariusz1979 (button) (small blind) collected (100)\r\n\r\nHand #99: \r\n\r\nPokerStars Hand #222090989598: Tournament #3091070723, $28.57+$1.43 USD Hold'em No Limit - Level IV (25/50) - 2021/01/01 10:22:10 ET\r\nTable '3091070723 1' 2-max Seat #1 is the button\r\nSeat 1: IPray2Buddha (2404 in chips) \r\nSeat 2: dariusz1979 (596 in chips) \r\nIPray2Buddha: posts small blind 25\r\ndariusz1979: posts big blind 50

\r\n*** HOLE CARDS ***\r\nDealt to IPray2Buddha [Jh Kc]\r\nIPray2Buddha: calls 25\r\ndariusz1979: checks \r\n*** FLOP *** [4d 9s 5d]\r\ndariusz1979: bets 546 and is all-in\r\nIPray2Buddha: folds \r\nUncalled bet (546) returned to dariusz1979\r\ndariusz1979 collected 100 from pot\r\ndariusz1979: doesn't show hand \r\n*** SUMMARY ***\r\nTotal pot 100 | Rake 0 \r\nBoard [4d 9s 5d]\r\nSeat 1: IPray2Buddha (button) (small blind) folded on the Flop\r\nSeat 2: dariusz1979 (big blind) collected (100)\r\n\r\nHand #100: \r\n\r\nPokerStars Hand #222091000448: Tournament #3091070723, $28.57+$1.43 USD Hold'em No Limit - Level IV (25/50) - 2021/01/01 10:22:32 ET\r\nTable '3091070723 1' 2-max Seat #2 is the button\r\nSeat 1: IPray2Buddha (2354 in chips) \r\nSeat 2: dariusz1979 (646 in chips) \r\ndariusz1979: posts small blind 25\r\nIPray2Buddha: posts big blind 50

\r\n*** HOLE CARDS ***\r\nDealt to IPray2Buddha [Ad 9s]\r\ndariusz1979: folds \r\nUncalled bet (25) returned to IPray2Buddha\r\nIPray2Buddha collected 50 from pot\r\n*** SUMMARY ***\r\nTotal pot 50 | Rake 0 \r\nSeat 1: IPray2Buddha (big blind) collected (50)\r\nSeat 2: dariusz1979 (button) (small blind) folded before Flop\r\n\r\n\r\nPokerStars Hand #232702845894: Tournament #3332579367, $9.22+$0.78 USD Hold'em No Limit - Level VII (100/200) - 2021/12/31 22:44:34 ET\r\nTable '3332579367 2' 9-max Seat #1 is the button\r\nSeat 1: Sakura2892 (549 in chips)\r\nSeat 2: TLNDink2749 (9728 in chips)\r\nSeat 3: Günex66 (2211 in chips)\r\nSeat 4: IPray2Buddha (3270 in chips)\r\nSeat 6: Willifold777 (4079 in chips)\r\nSeat 7: Sickofitall5 (3546 in chips)\r\nSeat 9: perussatto4 (3617 in chips)\r\nSakura2892: posts the ante 25\r\nTLNDink2749: posts the ante 25\r\nGünex66: posts the ante 25\r\nIPray2Buddha: posts the ante 25\r\nWillifold777: posts the ante 25\r\nSickofitall5: posts the ante 25\r\nperussatto4: posts the ante 25\r\nTLNDink2749: posts small blind 100\r\nGünex66: posts big blind 200

\r\n*** HOLE CARDS ***\r\nDealt to IPray2Buddha [4h Jc]\r\nIPray2Buddha: folds\r\nWillifold777: raises 200 to 400\r\nSickofitall5: folds\r\nperussatto4: folds\r\nSakura2892: raises 124 to 524 and is all-in\r\nTLNDink2749: folds\r\nGünex66: calls 324\r\nWillifold777: calls 124\r\n*** FLOP *** [Td 4d 4s]\r\nGünex66: checks\r\nWillifold777: checks\r\n*** TURN *** [Td 4d 4s] [Kd]\r\nGünex66: checks\r\nWillifold777: bets 924\r\nGünex66: folds\r\nUncalled bet (924) returned to Willifold777\r\n*** RIVER *** [Td 4d 4s Kd] [2c]\r\n*** SHOW DOWN ***\r\nWillifold777: shows [Js Ac] (a pair of Fours)\r\nSakura2892: shows [7h Ah] (a pair of Fours - lower kicker)\r\nWillifold777 collected 1847 from pot\r\nSakura2892 finished the tournament in 7th place\r\n*** SUMMARY ***\r\nTotal pot 1847 | Rake 0\r\nBoard [Td 4d 4s Kd 2c]\r\nSeat 1: Sakura2892 (button) showed [7h Ah] and lost with a pair of Fours\r\nSeat 2: TLNDink2749 (small blind) folded before Flop\r\nSeat 3: Günex66 (big blind) folded on the Turn\r\nSeat 4: IPray2Buddha folded before Flop (didn't bet)\r\nSeat 6: Willifold777 showed [Js Ac] and won (1847) with a pair of Fours\r\nSeat 7: Sickofitall5 folded before Flop (didn't bet)\r\nSeat 9: perussatto4 folded before Flop (didn't bet)\r\n\r\n\r\n\r\nPokerStars Hand #232702865436: Tournament #3332579367, $9.22+$0.78 USD Hold'em No Limit - Level VII (100/200) - 2021/12/31 22:46:07 ET\r\nTable '3332579367 2' 9-max Seat #3 is the button\r\nSeat 2: TLNDink2749 (9578 in chips)\r\nSeat 3: Günex66 (1537 in chips)\r\nSeat 4: IPray2Buddha (3020 in chips)\r\nSeat 6: Willifold777 (5352 in chips)\r\nSeat 7: Sickofitall5 (3946 in chips)\r\nSeat 9: perussatto4 (3567 in chips)\r\nTLNDink2749: posts the ante 25\r\nGünex66: posts the ante 25\r\nIPray2Buddha: posts the ante 25\r\nWillifold777: posts the ante 25\r\nSickofitall5: posts the ante 25\r\nperussatto4: posts the ante 25\r\nIPray2Buddha: posts small blind 100\r\nWillifold777: posts big blind 200


\r\n*** HOLE CARDS ***\r\nDealt to IPray2Buddha [Td 3c]\r\nSickofitall5: raises 400 to 600\r\nperussatto4: folds\r\nTLNDink2749: raises 400 to 1000\r\nGünex66: folds\r\nIPray2Buddha: folds\r\nWillifold777: folds\r\nSickofitall5: calls 400\r\n*** FLOP *** [5c 2s Js]\r\nSickofitall5: checks\r\nTLNDink2749: bets 200\r\nSickofitall5: calls 200\r\n*** TURN *** [5c 2s Js] [9h]\r\nSickofitall5: checks\r\nTLNDink2749: bets 1600\r\nSickofitall5: folds\r\nUncalled bet (1600) returned to TLNDink2749\r\nTLNDink2749 collected 2850 from pot\r\nTLNDink2749: doesn't show hand\r\n*** SUMMARY ***\r\nTotal pot 2850 | Rake 0\r\nBoard [5c 2s Js 9h]\r\nSeat 2: TLNDink2749 collected (2850)\r\nSeat 3: Günex66 (button) folded before Flop (didn't bet)\r\nSeat 4: IPray2Buddha (small blind) folded before Flop\r\nSeat 6: Willifold777 (big blind) folded before Flop\r\nSeat 7: Sickofitall5 folded on the Turn\r\nSeat 9: perussatto4 folded before Flop (didn't bet)\r\n\r\n\r\nPokerStars Hand #232702881786: Tournament #3332579367, $9.22+$0.78 USD Hold'em No Limit - Level VIII (150/300) - 2021/12/31 22:47:31 ET\r\nTable '3332579367 2' 9-max Seat #4 is the button\r\nSeat 2: TLNDink2749 (11203 in chips)\r\nSeat 3: Günex66 (1512 in chips)\r\nSeat 4: IPray2Buddha (2895 in chips)\r\nSeat 6: Willifold777 (5127 in chips)\r\nSeat 7: Sickofitall5 (2721 in chips)\r\nSeat 9: perussatto4 (3542 in chips)\r\nTLNDink2749: posts the ante 25\r\nGünex66: posts the ante 25\r\nIPray2Buddha: posts the ante 25\r\nWillifold777: posts the ante 25\r\nSickofitall5: posts the ante 25\r\nperussatto4: posts the ante 25\r\nWillifold777: posts small blind 150\r\nSickofitall5: posts big blind 300

\r\n*** HOLE CARDS ***\r\nDealt to IPray2Buddha [7d 5h]\r\nperussatto4: folds\r\nTLNDink2749: raises 300 to 600\r\nGünex66: folds\r\nIPray2Buddha: folds\r\nWillifold777: folds\r\nSickofitall5: folds\r\nUncalled bet (300) returned to TLNDink2749\r\nTLNDink2749 collected 900 from pot\r\nTLNDink2749: doesn't show hand\r\n*** SUMMARY ***\r\nTotal pot 900 | Rake 0\r\nSeat 2: TLNDink2749 collected (900)\r\nSeat 3: Günex66 folded before Flop (didn't bet)\r\nSeat 4: IPray2Buddha (button) folded before Flop (didn't bet)\r\nSeat 6: Willifold777 (small blind) folded before Flop\r\nSeat 7: Sickofitall5 (big blind) folded before Flop\r\nSeat 9: perussatto4 folded before Flop (didn't bet)\r\n\r\n\r\nPokerStars Hand #232702887927: Tournament #3332579367, $9.22+$0.78 USD Hold'em No Limit - Level VIII (150/300) - 2021/12/31 22:48:02 ET\r\nTable '3332579367 2' 9-max Seat #6 is the button\r\nSeat 2: TLNDink2749 (11778 in chips)\r\nSeat 3: Günex66 (1487 in chips)\r\nSeat 4: IPray2Buddha (2870 in chips)\r\nSeat 6: Willifold777 (4952 in chips)\r\nSeat 7: Sickofitall5 (2396 in chips)\r\nSeat 9: perussatto4 (3517 in chips)\r\nTLNDink2749: posts the ante 25\r\nGünex66: posts the ante 25\r\nIPray2Buddha: posts the ante 25\r\nWillifold777: posts the ante 25\r\nSickofitall5: posts the ante 25\r\nperussatto4: posts the ante 25\r\nSickofitall5: posts small blind 150\r\nperussatto4: posts big blind 300

\r\n*** HOLE CARDS ***\r\nDealt to IPray2Buddha [Ks Qh]\r\nTLNDink2749: raises 300 to 600\r\nGünex66: folds\r\nIPray2Buddha: folds\r\nWillifold777: folds\r\nSickofitall5: calls 450\r\nperussatto4: folds\r\n*** FLOP *** [7c 5d 3d]\r\nSickofitall5: bets 1771 and is all-in\r\nTLNDink2749: calls 1771\r\n*** TURN *** [7c 5d 3d] [4d]\r\n*** RIVER *** [7c 5d 3d 4d] [7s]\r\n*** SHOW DOWN ***\r\nSickofitall5: shows [As 4s] (two pair, Sevens and Fours)\r\nTLNDink2749: shows [2d 8s] (a pair of Sevens)\r\nSickofitall5 collected 5192 from pot\r\n*** SUMMARY ***\r\nTotal pot 5192 | Rake 0\r\nBoard [7c 5d 3d 4d 7s]\r\nSeat 2: TLNDink2749 showed [2d 8s] and lost with a pair of Sevens\r\nSeat 3: Günex66 folded before Flop (didn't bet)\r\nSeat 4: IPray2Buddha folded before Flop (didn't bet)\r\nSeat 6: Willifold777 (button) folded before Flop (didn't bet)\r\nSeat 7: Sickofitall5 (small blind) showed [As 4s] and won (5192) with two pair, Sevens and Fours\r\nSeat 9: perussatto4 (big blind) folded before Flop\r\n\r\n\r\nPokerStars Hand #232702897476: Tournament #3332579367, $9.22+$0.78 USD Hold'em No Limit - Level VIII (150/300) - 2021/12/31 22:48:44 ET\r\nTable '3332579367 2' 9-max Seat #7 is the button\r\nSeat 2: TLNDink2749 (9382 in chips)\r\nSeat 3: Günex66 (1462 in chips)\r\nSeat 4: IPray2Buddha (2845 in chips)\r\nSeat 6: Willifold777 (4927 in chips)\r\nSeat 7: Sickofitall5 (5192 in chips)\r\nSeat 9: perussatto4 (3192 in chips)\r\nTLNDink2749: posts the ante 25\r\nGünex66: posts the ante 25\r\nIPray2Buddha: posts the ante 25\r\nWillifold777: posts the ante 25\r\nSickofitall5: posts the ante 25\r\nperussatto4: posts the ante 25\r\nperussatto4: posts small blind 150\r\nTLNDink2749: posts big blind 300

\r\n*** HOLE CARDS ***\r\nDealt to IPray2Buddha [5s 4c]\r\nGünex66: folds\r\nIPray2Buddha: folds\r\nWillifold777: raises 300 to 600\r\nSickofitall5: folds\r\nperussatto4: folds\r\nTLNDink2749: raises 300 to 900\r\nWillifold777: calls 300\r\n*** FLOP *** [Td Ah 8s]\r\nTLNDink2749: bets 300\r\nWillifold777: calls 300\r\n*** TURN *** [Td Ah 8s] [2s]\r\nTLNDink2749: bets 300\r\nWillifold777: calls 300\r\n*** RIVER *** [Td Ah 8s 2s] [5h]\r\nTLNDink2749: bets 300\r\nWillifold777: calls 300\r\n*** SHOW DOWN ***\r\nTLNDink2749: shows [6c Qs] (high card Ace)\r\nWillifold777: shows [7c 7d] (a pair of Sevens)\r\nWillifold777 collected 3900 from pot\r\n*** SUMMARY ***\r\nTotal pot 3900 | Rake 0\r\nBoard [Td Ah 8s 2s 5h]\r\nSeat 2: TLNDink2749 (big blind) showed [6c Qs] and lost with high card Ace\r\nSeat 3: Günex66 folded before Flop (didn't bet)\r\nSeat 4: IPray2Buddha folded before Flop (didn't bet)\r\nSeat 6: Willifold777 showed [7c 7d] and won (3900) with a pair of Sevens\r\nSeat 7: Sickofitall5 (button) folded before Flop (didn't bet)\r\nSeat 9: perussatto4 (small blind) folded before Flop\r\n\r\n\r\nPokerStars Hand #232702905356: Tournament #3332579367, $9.22+$0.78 USD Hold'em No Limit - Level VIII (150/300) - 2021/12/31 22:49:24 ET\r\nTable '3332579367 2' 9-max Seat #9 is the button\r\nSeat 2: TLNDink2749 (7557 in chips)\r\nSeat 3: Günex66 (1437 in chips)\r\nSeat 4: IPray2Buddha (2820 in chips)\r\nSeat 6: Willifold777 (7002 in chips)\r\nSeat 7: Sickofitall5 (5167 in chips)\r\nSeat 9: perussatto4 (3017 in chips)\r\nTLNDink2749: posts the ante 25\r\nGünex66: posts the ante 25\r\nIPray2Buddha: posts the ante 25\r\nWillifold777: posts the ante 25\r\nSickofitall5: posts the ante 25\r\nperussatto4: posts the ante 25\r\nTLNDink2749: posts small blind 150\r\nGünex66: posts big blind 300

\r\n*** HOLE CARDS ***\r\nDealt to IPray2Buddha [3s Kc]\r\nIPray2Buddha: folds\r\nWillifold777: folds\r\nSickofitall5: raises 300 to 600\r\nperussatto4: folds\r\nTLNDink2749: calls 450\r\n\r\nGünex66: folds\r\n\r\n*** FLOP *** [6h 5d 4h]\r\nTLNDink2749: bets 300\r\n\r\nSickofitall5: calls 300\r\n*** TURN *** [6h 5d 4h] [Ts]\r\nTLNDink2749: bets 300\r\nSickofitall5: calls 300\r\n*** RIVER *** [6h 5d 4h Ts] [5h]\r\nTLNDink2749: bets 900\r\nSickofitall5: calls 900\r\n*** SHOW DOWN ***\r\nTLNDink2749: shows [6s Js] (two pair, Sixes and Fives)\r\n\r\nTLNDink2749 collected 4650 from pot\r\n*** SUMMARY ***\r\nTotal pot 4650 | Rake 0\r\nBoard [6h 5d 4h Ts 5h]\r\nSeat 2: TLNDink2749 (small blind) showed [6s Js] and won (4650) with two pair, Sixes and Fives\r\nSeat 3: Günex66 (big blind) folded before Flop\r\nSeat 4: IPray2Buddha folded before Flop (didn't bet)\r\nSeat 6: Willifold777 folded before Flop (didn't bet)\r\nSeat 7: Sickofitall5 mucked [Ac 2c]\r\nSeat 9: perussatto4 (button) folded before Flop (didn't bet)\r\n\r\n\r\nPokerStars Hand #232702916868: Tournament #3332579367, $9.22+$0.78 USD Hold'em No Limit - Level VIII (150/300) - 2021/12/31 22:50:24 ET\r\nTable '3332579367 2' 9-max Seat #2 is the button\r\nSeat 2: TLNDink2749 (10082 in chips)\r\nSeat 3: Günex66 (1112 in chips)\r\nSeat 4: IPray2Buddha (2795 in chips)\r\nSeat 6: Willifold777 (6977 in chips)\r\nSeat 7: Sickofitall5 (3042 in chips)\r\nSeat 9: perussatto4 (2992 in chips)\r\nTLNDink2749: posts the ante 25\r\nGünex66: posts the ante 25\r\nIPray2Buddha: posts the ante 25\r\nWillifold777: posts the ante 25\r\nSickofitall5: posts the ante 25\r\nperussatto4: posts the ante 25\r\nGünex66: posts small blind 150\r\nIPray2Buddha: posts big blind 300

\r\n*** HOLE CARDS ***\r\nDealt to IPray2Buddha [3h Td]\r\nWillifold777: folds\r\nSickofitall5: raises 2717 to 3017 and is all-in\r\nperussatto4: folds\r\nTLNDink2749: folds\r\nGünex66: calls 937 and is all-in\r\nIPray2Buddha: folds\r\nUncalled bet (1930) returned to Sickofitall5\r\n*** FLOP *** [6d Jh 9s]\r\n*** TURN *** [6d Jh 9s] [6s]\r\n*** RIVER *** [6d Jh 9s 6s] [Tc]\r\n*** SHOW DOWN ***\r\nGünex66: shows [Kd Jd] (two pair, Jacks and Sixes)\r\nSickofitall5: shows [Kc 6c] (three of a kind, Sixes)\r\nSickofitall5 collected 2624 from pot\r\nGünex66 finished the tournament in 6th place\r\n*** SUMMARY ***\r\nTotal pot 2624 | Rake 0\r\nBoard [6d Jh 9s 6s Tc]\r\nSeat 2: TLNDink2749 (button) folded before Flop (didn't bet)\r\nSeat 3: Günex66 (small blind) showed [Kd Jd] and lost with two pair, Jacks and Sixes\r\nSeat 4: IPray2Buddha (big blind) folded before Flop\r\nSeat 6: Willifold777 folded before Flop (didn't bet)\r\nSeat 7: Sickofitall5 showed [Kc 6c] and won (2624) with three of a kind, Sixes\r\nSeat 9: perussatto4 folded before Flop (didn't bet)\r\n\r\n\r\nPokerStars Hand #232702922986: Tournament #3332579367, $9.22+$0.78 USD Hold'em No Limit - Level VIII (150/300) - 2021/12/31 22:50:56 ET\r\nTable '3332579367 2' 9-max Seat #4 is the button\r\nSeat 2: TLNDink2749 (10057 in chips)\r\nSeat 4: IPray2Buddha (2470 in chips)\r\nSeat 6: Willifold777 (6952 in chips)\r\nSeat 7: Sickofitall5 (4554 in chips)\r\nSeat 9: perussatto4 (2967 in chips)\r\nTLNDink2749: posts the ante 25\r\nIPray2Buddha: posts the ante 25\r\nWillifold777: posts the ante 25\r\nSickofitall5: posts the ante 25\r\nperussatto4: posts the ante 25\r\nWillifold777: posts small blind 150\r\nSickofitall5: posts big blind 300

\r\n*** HOLE CARDS ***\r\nDealt to IPray2Buddha [2c Js]\r\nperussatto4: raises 2642 to 2942 and is all-in\r\nTLNDink2749: folds\r\nIPray2Buddha: folds\r\nWillifold777: folds\r\nSickofitall5: folds\r\nUncalled bet (2642) returned to perussatto4\r\nperussatto4 collected 875 from pot\r\n*** SUMMARY ***\r\nTotal pot 875 | Rake 0\r\nSeat 2: TLNDink2749 folded before Flop (didn't bet)\r\nSeat 4: IPray2Buddha (button) folded before Flop (didn't bet)\r\nSeat 6: Willifold777 (small blind) folded before Flop\r\nSeat 7: Sickofitall5 (big blind) folded before Flop\r\nSeat 9: perussatto4 collected (875)\r\n\r\n\r\nPokerStars Hand #232702930440: Tournament #3332579367, $9.22+$0.78 USD Hold'em No Limit - Level VIII (150/300) - 2021/12/31 22:51:34 ET\r\nTable '3332579367 2' 9-max Seat #6 is the button\r\nSeat 2: TLNDink2749 (10032 in chips)\r\nSeat 4: IPray2Buddha (2445 in chips)\r\nSeat 6: Willifold777 (6777 in chips)\r\nSeat 7: Sickofitall5 (4229 in chips)\r\nSeat 9: perussatto4 (3517 in chips)\r\nTLNDink2749: posts the ante 25\r\nIPray2Buddha: posts the ante 25\r\nWillifold777: posts the ante 25\r\nSickofitall5: posts the ante 25\r\nperussatto4: posts the ante 25\r\nSickofitall5: posts small blind 150\r\nperussatto4: posts big blind 300

\r\n*** HOLE CARDS ***\r\nDealt to IPray2Buddha [Js 7s]\r\nTLNDink2749: calls 300\r\nIPray2Buddha: folds\r\nWillifold777: folds\r\nSickofitall5: calls 150\r\nperussatto4: checks\r\n*** FLOP *** [5h 4s Qd]\r\nSickofitall5: checks\r\nperussatto4: checks\r\nTLNDink2749: checks\r\n*** TURN *** [5h 4s Qd] [9s]\r\nSickofitall5: checks\r\nperussatto4: checks\r\nTLNDink2749: checks\r\n*** RIVER *** [5h 4s Qd 9s] [3d]\r\nSickofitall5: checks\r\nperussatto4: checks\r\nTLNDink2749: checks\r\n*** SHOW DOWN ***\r\nSickofitall5: shows [8c 8h] (a pair of Eights)\r\n\r\n\r\nSickofitall5 collected 1025 from pot\r\n*** SUMMARY ***\r\nTotal pot 1025 | Rake 0\r\nBoard [5h 4s Qd 9s 3d]\r\nSeat 2: TLNDink2749 mucked [7c 8s]\r\nSeat 4: IPray2Buddha folded before Flop (didn't bet)\r\nSeat 6: Willifold777 (button) folded before Flop (didn't bet)\r\nSeat 7: Sickofitall5 (small blind) showed [8c 8h] and won (1025) with a pair of Eights\r\nSeat 9: perussatto4 (big blind) mucked [5d Tc]\r\n\r\n\r\nPokerStars Hand #232702950427: Tournament #3332579367, $9.22+$0.78 USD Hold'em No Limit - Level IX (200/400) - 2021/12/31 22:52:28 ET\r\nTable '3332579367 2' 9-max Seat #7 is the button\r\nSeat 2: TLNDink2749 (9707 in chips)\r\nSeat 4: IPray2Buddha (2420 in chips)\r\nSeat 6: Willifold777 (6752 in chips)\r\nSeat 7: Sickofitall5 (4929 in chips)\r\nSeat 9: perussatto4 (3192 in chips)\r\nTLNDink2749: posts the ante 25\r\nIPray2Buddha: posts the ante 25\r\nWillifold777: posts the ante 25\r\nSickofitall5: posts the ante 25\r\nperussatto4: posts the ante 25\r\nperussatto4: posts small blind 200\r\nTLNDink2749: posts big blind 400

\r\n*** HOLE CARDS ***\r\nDealt to IPray2Buddha [7d Ks]\r\nIPray2Buddha: folds\r\nWillifold777: raises 400 to 800\r\nSickofitall5: folds\r\nperussatto4: raises 2367 to 3167 and is all-in\r\nTLNDink2749: folds\r\nWillifold777: folds\r\nUncalled bet (2367) returned to perussatto4\r\nperussatto4 collected 2125 from pot\r\n*** SUMMARY ***\r\nTotal pot 2125 | Rake 0\r\nSeat 2: TLNDink2749 (big blind) folded before Flop\r\nSeat 4: IPray2Buddha folded before Flop (didn't bet)\r\nSeat 6: Willifold777 folded before Flop\r\nSeat 7: Sickofitall5 (button) folded before Flop (didn't bet)\r\nSeat 9: perussatto4 (small blind) collected (2125)\r\n\r\n\r\nPokerStars Hand #232702967652: Tournament #3332579367, $9.22+$0.78 USD Hold'em No Limit - Level IX (200/400) - 2021/12/31 22:53:13 ET\r\nTable '3332579367 2' 9-max Seat #9 is the button\r\nSeat 2: TLNDink2749 (9282 in chips)\r\nSeat 4: IPray2Buddha (2395 in chips)\r\nSeat 6: Willifold777 (5927 in chips)\r\nSeat 7: Sickofitall5 (4904 in chips)\r\nSeat 9: perussatto4 (4492 in chips)\r\nTLNDink2749: posts the ante 25\r\nIPray2Buddha: posts the ante 25\r\nWillifold777: posts the ante 25\r\nSickofitall5: posts the ante 25\r\nperussatto4: posts the ante 25\r\nTLNDink2749: posts small blind 200\r\nIPray2Buddha: posts big blind 400

\r\n*** HOLE CARDS ***\r\nDealt to IPray2Buddha [Jd 5s]\r\nWillifold777: folds\r\nSickofitall5: raises 4479 to 4879 and is all-in\r\nperussatto4: folds\r\nTLNDink2749: folds\r\nIPray2Buddha: folds\r\nUncalled bet (4479) returned to Sickofitall5\r\nSickofitall5 collected 1125 from pot\r\n*** SUMMARY ***\r\nTotal pot 1125 | Rake 0\r\nSeat 2: TLNDink2749 (small blind) folded before Flop\r\nSeat 4: IPray2Buddha (big blind) folded before Flop\r\nSeat 6: Willifold777 folded before Flop (didn't bet)\r\nSeat 7: Sickofitall5 collected (1125)\r\nSeat 9: perussatto4 (button) folded before Flop (didn't bet)\r\n\r\n\r\nPokerStars Hand #232702973065: Tournament #3332579367, $9.22+$0.78 USD Hold'em No Limit - Level IX (200/400) - 2021/12/31 22:53:41 ET\r\nTable '3332579367 2' 9-max Seat #2 is the button\r\nSeat 2: TLNDink2749 (9057 in chips)\r\nSeat 4: IPray2Buddha (1970 in chips)\r\nSeat 6: Willifold777 (5902 in chips)\r\nSeat 7: Sickofitall5 (5604 in chips)\r\nSeat 9: perussatto4 (4467 in chips)\r\nTLNDink2749: posts the ante 25\r\nIPray2Buddha: posts the ante 25\r\nWillifold777: posts the ante 25\r\nSickofitall5: posts the ante 25\r\nperussatto4: posts the ante 25\r\nIPray2Buddha: posts small blind 200\r\nWillifold777: posts big blind 400

\r\n*** HOLE CARDS ***\r\nDealt to IPray2Buddha [Qs 4h]\r\nSickofitall5: raises 400 to 800\r\nperussatto4: folds\r\nTLNDink2749: calls 800\r\nIPray2Buddha: folds\r\nWillifold777: folds\r\n*** FLOP *** [Kc 6d 8h]\r\nSickofitall5: checks\r\nTLNDink2749: bets 400\r\nSickofitall5: calls 400\r\n*** TURN *** [Kc 6d 8h] [5d]\r\nSickofitall5: checks\r\nTLNDink2749: bets 400\r\nSickofitall5: calls 400\r\n*** RIVER *** [Kc 6d 8h 5d] [3c]\r\nSickofitall5: checks\r\nTLNDink2749: bets 800\r\nSickofitall5: calls 800\r\n*** SHOW DOWN ***\r\nTLNDink2749: shows [Js 3h] (a pair of Threes)\r\nSickofitall5: shows [9h Kh] (a pair of Kings)\r\nSickofitall5 collected 5525 from pot\r\n*** SUMMARY ***\r\nTotal pot 5525 | Rake 0\r\nBoard [Kc 6d 8h 5d 3c]\r\nSeat 2: TLNDink2749 (button) showed [Js 3h] and lost with a pair of Threes\r\nSeat 4: IPray2Buddha (small blind) folded before Flop\r\nSeat 6: Willifold777 (big blind) folded before Flop\r\nSeat 7: Sickofitall5 showed [9h Kh] and won (5525) with a pair of Kings\r\nSeat 9: perussatto4 folded before Flop (didn't bet)\r\n\r\n\r\n\r\nPokerStars Hand #232702464732: Tournament #3332581238, $9.22+$0.78 USD Hold'em No Limit - Level I (10/20) - 2021/12/31 22:16:40 ET\r\nTable '3332581238 1' 9-max Seat #1 is the button\r\nSeat 1: mpolishuk (1500 in chips)\r\nSeat 2: cameltoe3350 (1500 in chips)\r\nSeat 3: Kevin2049 (1500 in chips)\r\nSeat 4: IPray2Buddha (1500 in chips)\r\nSeat 5: Sakura2892 (1500 in chips)\r\nSeat 6: GFJun10r (1500 in chips)\r\nSeat 7: Lillien66 (1500 in chips)\r\nSeat 8: 100%tigerfan (1500 in chips)\r\nSeat 9: owlie45 (1500 in chips)\r\nmpolishuk: posts the ante 3\r\ncameltoe3350: posts the ante 3\r\nKevin2049: posts the ante 3\r\nIPray2Buddha: posts the ante 3\r\nSakura2892: posts the ante 3\r\nGFJun10r: posts the ante 3\r\nLillien66: posts the ante 3\r\n100%tigerfan: posts the ante 3\r\nowlie45: posts the ante 3\r\ncameltoe3350: posts small blind 10\r\nKevin2049: posts big blind 20

\r\n*** HOLE CARDS ***\r\nDealt to IPray2Buddha [Ac Tc]\r\nIPray2Buddha: raises 40 to 60\r\nSakura2892: folds\r\nGFJun10r: folds\r\nLillien66: folds\r\n100%tigerfan: folds\r\nowlie45: folds\r\nmpolishuk: folds\r\ncameltoe3350: folds\r\nKevin2049: raises 157 to 217\r\nIPray2Buddha: calls 157\r\n*** FLOP *** [4h 8h As]\r\nKevin2049: checks\r\nIPray2Buddha: checks\r\n*** TURN *** [4h 8h As] [5c]\r\nKevin2049: bets 120\r\nIPray2Buddha: calls 120\r\n*** RIVER *** [4h 8h As 5c] [3d]\r\nKevin2049: checks\r\nIPray2Buddha: bets 600\r\nKevin2049: folds\r\nUncalled bet (600) returned to IPray2Buddha\r\nIPray2Buddha collected 711 from pot\r\n*** SUMMARY ***\r\nTotal pot 711 | Rake 0\r\nBoard [4h 8h As 5c 3d]\r\nSeat 1: mpolishuk (button) folded before Flop (didn't bet)\r\nSeat 2: cameltoe3350 (small blind) folded before Flop\r\nSeat 3: Kevin2049 (big blind) folded on the River\r\nSeat 4: IPray2Buddha collected (711)\r\nSeat 5: Sakura2892 folded before Flop (didn't bet)\r\nSeat 6: GFJun10r folded before Flop (didn't bet)\r\nSeat 7: Lillien66 folded before Flop (didn't bet)\r\nSeat 8: 100%tigerfan folded before Flop (didn't bet)\r\nSeat 9: owlie45 folded before Flop (didn't bet)\r\n\r\n\r\nPokerStars Hand #232702491957: Tournament #3332581238, $9.22+$0.78 USD Hold'em No Limit - Level I (10/20) - 2021/12/31 22:18:28 ET\r\nTable '3332581238 1' 9-max Seat #2 is the button\r\nSeat 1: mpolishuk (1497 in chips)\r\nSeat 2: cameltoe3350 (1487 in chips)\r\nSeat 3: Kevin2049 (1160 in chips)\r\nSeat 4: IPray2Buddha (1871 in chips)\r\nSeat 5: Sakura2892 (1497 in chips)\r\nSeat 6: GFJun10r (1497 in chips)\r\nSeat 7: Lillien66 (1497 in chips)\r\nSeat 8: 100%tigerfan (1497 in chips)\r\nSeat 9: owlie45 (1497 in chips)\r\nmpolishuk: posts the ante 3\r\ncameltoe3350: posts the ante 3\r\nKevin2049: posts the ante 3\r\nIPray2Buddha: posts the ante 3\r\nSakura2892: posts the ante 3\r\nGFJun10r: posts the ante 3\r\nLillien66: posts the ante 3\r\n100%tigerfan: posts the ante 3\r\nowlie45: posts the ante 3\r\nKevin2049: posts small blind 10\r\nIPray2Buddha: posts big blind 20

\r\n*** HOLE CARDS ***\r\nDealt to IPray2Buddha [4s 9d]\r\nSakura2892: folds\r\nGFJun10r: raises 29 to 49\r\nLillien66: folds\r\n100%tigerfan: folds\r\nowlie45: folds\r\nmpolishuk: raises 121 to 170\r\ncameltoe3350: folds\r\nKevin2049: folds\r\nIPray2Buddha: folds\r\nGFJun10r: calls 121\r\n*** FLOP *** [6d Js 9h]\r\nGFJun10r: checks\r\nmpolishuk: bets 199\r\nGFJun10r: folds\r\nUncalled bet (199) returned to mpolishuk\r\nmpolishuk collected 397 from pot\r\nmpolishuk: doesn't show hand\r\n*** SUMMARY ***\r\nTotal pot 397 | Rake 0\r\nBoard [6d Js 9h]\r\nSeat 1: mpolishuk collected (397)\r\nSeat 2: cameltoe3350 (button) folded before Flop (didn't bet)\r\nSeat 3: Kevin2049 (small blind) folded before Flop\r\nSeat 4: IPray2Buddha (big blind) folded before Flop\r\nSeat 5: Sakura2892 folded before Flop (didn't bet)\r\nSeat 6: GFJun10r folded on the Flop\r\nSeat 7: Lillien66 folded before Flop (didn't bet)\r\nSeat 8: 100%tigerfan folded before Flop (didn't bet)\r\nSeat 9: owlie45 folded before Flop (didn't bet)\r\n\r\n\r\nPokerStars Hand #232702507303: Tournament #3332581238, $9.22+$0.78 USD Hold'em No Limit - Level I (10/20) - 2021/12/31 22:19:21 ET\r\nTable '3332581238 1' 9-max Seat #3 is the button\r\nSeat 1: mpolishuk (1721 in chips)\r\nSeat 2: cameltoe3350 (1484 in chips)\r\nSeat 3: Kevin2049 (1147 in chips)\r\nSeat 4: IPray2Buddha (1848 in chips)\r\nSeat 5: Sakura2892 (1494 in chips)\r\nSeat 6: GFJun10r (1324 in chips)\r\nSeat 7: Lillien66 (1494 in chips)\r\nSeat 8: 100%tigerfan (1494 in chips)\r\nSeat 9: owlie45 (1494 in chips)\r\nmpolishuk: posts the ante 3\r\ncameltoe3350: posts the ante 3\r\nKevin2049: posts the ante 3\r\nIPray2Buddha: posts the ante 3\r\nSakura2892: posts the ante 3\r\nGFJun10r: posts the ante 3\r\nLillien66: posts the ante 3\r\n100%tigerfan: posts the ante 3\r\nowlie45: posts the ante 3\r\nIPray2Buddha: posts small blind 10\r\nSakura2892: posts big blind 20

\r\n*** HOLE CARDS ***\r\nDealt to IPray2Buddha [8d 9s]\r\nGFJun10r: raises 40 to 60\r\nLillien66: folds\r\n100%tigerfan: calls 60\r\nowlie45: raises 220 to 280\r\nmpolishuk: folds\r\ncameltoe3350: folds\r\nKevin2049: folds\r\nIPray2Buddha: folds\r\nSakura2892: folds\r\nGFJun10r: calls 220\r\n100%tigerfan: folds\r\n*** FLOP *** [Qs 2h 2c]\r\nGFJun10r: checks\r\nowlie45: bets 160\r\nGFJun10r: calls 160\r\n*** TURN *** [Qs 2h 2c] [3c]\r\nGFJun10r: checks\r\nowlie45: checks\r\n*** RIVER *** [Qs 2h 2c 3c] [Kc]\r\nGFJun10r: checks\r\nowlie45: bets 1051 and is all-in\r\nGFJun10r: folds\r\nUncalled bet (1051) returned to owlie45\r\nowlie45 collected 997 from pot\r\nowlie45: doesn't show hand\r\n*** SUMMARY ***\r\nTotal pot 997 | Rake 0\r\nBoard [Qs 2h 2c 3c Kc]\r\nSeat 1: mpolishuk folded before Flop (didn't bet)\r\nSeat 2: cameltoe3350 folded before Flop (didn't bet)\r\nSeat 3: Kevin2049 (button) folded before Flop (didn't bet)\r\nSeat 4: IPray2Buddha (small blind) folded before Flop\r\nSeat 5: Sakura2892 (big blind) folded before Flop\r\nSeat 6: GFJun10r folded on the River\r\nSeat 7: Lillien66 folded before Flop (didn't bet)\r\nSeat 8: 100%tigerfan folded before Flop\r\nSeat 9: owlie45 collected (997)\r\n\r\n\r\nPokerStars Hand #232702522368: Tournament #3332581238, $9.22+$0.78 USD Hold'em No Limit - Level I (10/20) - 2021/12/31 22:20:31 ET\r\nTable '3332581238 1' 9-max Seat #4 is the button\r\nSeat 1: mpolishuk (1718 in chips)\r\nSeat 2: cameltoe3350 (1481 in chips)\r\nSeat 3: Kevin2049 (1144 in chips)\r\nSeat 4: IPray2Buddha (1835 in chips)\r\nSeat 5: Sakura2892 (1471 in chips)\r\nSeat 6: GFJun10r (881 in chips)\r\nSeat 7: Lillien66 (1491 in chips)\r\nSeat 8: 100%tigerfan (1431 in chips)\r\nSeat 9: owlie45 (2048 in chips)\r\nmpolishuk: posts the ante 3\r\ncameltoe3350: posts the ante 3\r\nKevin2049: posts the ante 3\r\nIPray2Buddha: posts the ante 3\r\nSakura2892: posts the ante 3\r\nGFJun10r: posts the ante 3\r\nLillien66: posts the ante 3\r\n100%tigerfan: posts the ante 3\r\nowlie45: posts the ante 3\r\nSakura2892: posts small blind 10\r\nGFJun10r: posts big blind 20

\r\n*** HOLE CARDS ***\r\nDealt to IPray2Buddha [Js 4s]\r\nLillien66: folds\r\n100%tigerfan: folds\r\nowlie45: folds\r\nmpolishuk: folds\r\ncameltoe3350: folds\r\nKevin2049: folds\r\nIPray2Buddha: raises 22 to 42\r\nSakura2892: folds\r\nGFJun10r: calls 22\r\n*** FLOP *** [Ac 3d Jc]\r\nGFJun10r: checks\r\nIPray2Buddha: checks\r\n*** TURN *** [Ac 3d Jc] [8s]\r\nGFJun10r: bets 121\r\nIPray2Buddha: calls 121\r\n*** RIVER *** [Ac 3d Jc 8s] [Qs]\r\nGFJun10r: bets 159\r\nIPray2Buddha: folds\r\nUncalled bet (159) returned to GFJun10r\r\nGFJun10r collected 363 from pot\r\nGFJun10r: doesn't show hand\r\n*** SUMMARY ***\r\nTotal pot 363 | Rake 0\r\nBoard [Ac 3d Jc 8s Qs]\r\nSeat 1: mpolishuk folded before Flop (didn't bet)\r\nSeat 2: cameltoe3350 folded before Flop (didn't bet)\r\nSeat 3: Kevin2049 folded before Flop (didn't bet)\r\nSeat 4: IPray2Buddha (button) folded on the River\r\nSeat 5: Sakura2892 (small blind) folded before Flop\r\nSeat 6: GFJun10r (big blind) collected (363)\r\nSeat 7: Lillien66 folded before Flop (didn't bet)\r\nSeat 8: 100%tigerfan folded before Flop (didn't bet)\r\nSeat 9: owlie45 folded before Flop (didn't bet)\r\n\r\n\r\nPokerStars Hand #232702533216: Tournament #3332581238, $9.22+$0.78 USD Hold'em No Limit - Level I (10/20) - 2021/12/31 22:21:23 ET\r\nTable '3332581238 1' 9-max Seat #5 is the button\r\nSeat 1: mpolishuk (1715 in chips)\r\nSeat 2: cameltoe3350 (1478 in chips)\r\nSeat 3: Kevin2049 (1141 in chips)\r\nSeat 4: IPray2Buddha (1669 in chips)\r\nSeat 5: Sakura2892 (1458 in chips)\r\nSeat 6: GFJun10r (1078 in chips)\r\nSeat 7: Lillien66 (1488 in chips)\r\nSeat 8: 100%tigerfan (1428 in chips)\r\nSeat 9: owlie45 (2045 in chips)\r\nmpolishuk: posts the ante 3\r\ncameltoe3350: posts the ante 3\r\nKevin2049: posts the ante 3\r\nIPray2Buddha: posts the ante 3\r\nSakura2892: posts the ante 3\r\nGFJun10r: posts the ante 3\r\nLillien66: posts the ante 3\r\n100%tigerfan: posts the ante 3\r\nowlie45: posts the ante 3\r\nGFJun10r: posts small blind 10\r\nLillien66: posts big blind 20

\r\n*** HOLE CARDS ***\r\nDealt to IPray2Buddha [7s Qh]\r\n100%tigerfan: folds\r\nowlie45: raises 23 to 43\r\nmpolishuk: folds\r\ncameltoe3350: folds\r\nKevin2049: folds\r\nIPray2Buddha: folds\r\nSakura2892: calls 43\r\nGFJun10r: folds\r\nLillien66: folds\r\n*** FLOP *** [3s 5s 9s]\r\nowlie45: checks\r\nSakura2892: checks\r\n*** TURN *** [3s 5s 9s] [8s]\r\nowlie45: checks\r\nSakura2892: checks\r\n*** RIVER *** [3s 5s 9s 8s] [5h]\r\nowlie45: bets 47\r\nSakura2892: folds\r\nUncalled bet (47) returned to owlie45\r\nowlie45 collected 143 from pot\r\nowlie45: doesn't show hand\r\n*** SUMMARY ***\r\nTotal pot 143 | Rake 0\r\nBoard [3s 5s 9s 8s 5h]\r\nSeat 1: mpolishuk folded before Flop (didn't bet)\r\nSeat 2: cameltoe3350 folded before Flop (didn't bet)\r\nSeat 3: Kevin2049 folded before Flop (didn't bet)\r\nSeat 4: IPray2Buddha folded before Flop (didn't bet)\r\nSeat 5: Sakura2892 (button) folded on the River\r\nSeat 6: GFJun10r (small blind) folded before Flop\r\nSeat 7: Lillien66 (big blind) folded before Flop\r\nSeat 8: 100%tigerfan folded before Flop (didn't bet)\r\nSeat 9: owlie45 collected (143)\r\n\r\n\r\nPokerStars Hand #232702547804: Tournament #3332581238, $9.22+$0.78 USD Hold'em No Limit - Level II (15/30) - 2021/12/31 22:22:24 ET\r\nTable '3332581238 1' 9-max Seat #6 is the button\r\nSeat 1: mpolishuk (1712 in chips)\r\nSeat 2: cameltoe3350 (1475 in chips)\r\nSeat 3: Kevin2049 (1138 in chips)\r\nSeat 4: IPray2Buddha (1666 in chips)\r\nSeat 5: Sakura2892 (1412 in chips)\r\nSeat 6: GFJun10r (1065 in chips)\r\nSeat 7: Lillien66 (1465 in chips)\r\nSeat 8: 100%tigerfan (1425 in chips)\r\nSeat 9: owlie45 (2142 in chips)\r\nmpolishuk: posts the ante 4\r\ncameltoe3350: posts the ante 4\r\nKevin2049: posts the ante 4\r\nIPray2Buddha: posts the ante 4\r\nSakura2892: posts the ante 4\r\nGFJun10r: posts the ante 4\r\nLillien66: posts the ante 4\r\n100%tigerfan: posts the ante 4\r\nowlie45: posts the ante 4\r\nLillien66: posts small blind 15\r\n100%tigerfan: posts big blind 30

\r\n*** HOLE CARDS ***\r\nDealt to IPray2Buddha [2c 9h]\r\nowlie45: folds\r\nmpolishuk: folds\r\ncameltoe3350: folds\r\nKevin2049: folds\r\nIPray2Buddha: folds\r\nSakura2892: folds\r\nGFJun10r: raises 60 to 90\r\nLillien66: raises 120 to 210\r\n100%tigerfan: folds\r\nGFJun10r: calls 120\r\n*** FLOP *** [2d Ah Ad]\r\nLillien66: bets 180\r\nGFJun10r: raises 671 to 851 and is all-in\r\nLillien66: calls 671\r\n*** TURN *** [2d Ah Ad] [As]\r\n*** RIVER *** [2d Ah Ad As] [Ts]\r\n*** SHOW DOWN ***\r\nLillien66: shows [Ac Jh] (four of a kind, Aces)\r\nGFJun10r: shows [Js 4s] (three of a kind, Aces)\r\nLillien66 collected 2188 from pot\r\nGFJun10r finished the tournament in 17th place\r\n*** SUMMARY ***\r\nTotal pot 2188 | Rake 0\r\nBoard [2d Ah Ad As Ts]\r\nSeat 1: mpolishuk folded before Flop (didn't bet)\r\nSeat 2: cameltoe3350 folded before Flop (didn't bet)\r\nSeat 3: Kevin2049 folded before Flop (didn't bet)\r\nSeat 4: IPray2Buddha folded before Flop (didn't bet)\r\nSeat 5: Sakura2892 folded before Flop (didn't bet)\r\nSeat 6: GFJun10r (button) showed [Js 4s] and lost with three of a kind, Aces\r\nSeat 7: Lillien66 (small blind) showed [Ac Jh] and won (2188) with four of a kind, Aces\r\nSeat 8: 100%tigerfan (big blind) folded before Flop\r\nSeat 9: owlie45 folded before Flop (didn't bet)\r\n\r\n\r\nPokerStars Hand #232702558807: Tournament #3332581238, $9.22+$0.78 USD Hold'em No Limit - Level II (15/30) - 2021/12/31 22:23:16 ET\r\nTable '3332581238 1' 9-max Seat #7 is the button\r\nSeat 1: mpolishuk (1708 in chips)\r\nSeat 2: cameltoe3350 (1471 in chips)\r\nSeat 3: Kevin2049 (1134 in chips)\r\nSeat 4: IPray2Buddha (1662 in chips)\r\nSeat 5: Sakura2892 (1408 in chips)\r\nSeat 7: Lillien66 (2588 in chips)\r\nSeat 8: 100%tigerfan (1391 in chips)\r\nSeat 9: owlie45 (2138 in chips)\r\nmpolishuk: posts the ante 4\r\ncameltoe3350: posts the ante 4\r\nKevin2049: posts the ante 4\r\nIPray2Buddha: posts the ante 4\r\nSakura2892: posts the ante 4\r\nLillien66: posts the ante 4\r\n100%tigerfan: posts the ante 4\r\nowlie45: posts the ante 4\r\n100%tigerfan: posts small blind 15\r\nowlie45: posts big blind 30

\r\n*** HOLE CARDS ***\r\nDealt to IPray2Buddha [5d 3h]\r\nmpolishuk: raises 45 to 75\r\ncameltoe3350: folds\r\nKevin2049: folds\r\nIPray2Buddha: folds\r\nSakura2892: folds\r\nLillien66: folds\r\n100%tigerfan: folds\r\nowlie45: folds\r\nUncalled bet (45) returned to mpolishuk\r\nmpolishuk collected 107 from pot\r\nmpolishuk: doesn't show hand\r\n*** SUMMARY ***\r\nTotal pot 107 | Rake 0\r\nSeat 1: mpolishuk collected (107)\r\nSeat 2: cameltoe3350 folded before Flop (didn't bet)\r\nSeat 3: Kevin2049 folded before Flop (didn't bet)\r\nSeat 4: IPray2Buddha folded before Flop (didn't bet)\r\nSeat 5: Sakura2892 folded before Flop (didn't bet)\r\nSeat 7: Lillien66 (button) folded before Flop (didn't bet)\r\nSeat 8: 100%tigerfan (small blind) folded before Flop\r\nSeat 9: owlie45 (big blind) folded before Flop\r\n\r\n\r\nPokerStars Hand #232702564083: Tournament #3332581238, $9.22+$0.78 USD Hold'em No Limit - Level II (15/30) - 2021/12/31 22:23:41 ET\r\nTable '3332581238 1' 9-max Seat #8 is the button\r\nSeat 1: mpolishuk (1781 in chips)\r\nSeat 2: cameltoe3350 (1467 in chips)\r\nSeat 3: Kevin2049 (1130 in chips)\r\nSeat 4: IPray2Buddha (1658 in chips)\r\nSeat 5: Sakura2892 (1404 in chips)\r\nSeat 7: Lillien66 (2584 in chips)\r\nSeat 8: 100%tigerfan (1372 in chips)\r\nSeat 9: owlie45 (2104 in chips)\r\nmpolishuk: posts the ante 4\r\ncameltoe3350: posts the ante 4\r\nKevin2049: posts the ante 4\r\nIPray2Buddha: posts the ante 4\r\nSakura2892: posts the ante 4\r\nLillien66: posts the ante 4\r\n100%tigerfan: posts the ante 4\r\nowlie45: posts the ante 4\r\nowlie45: posts small blind 15\r\nmpolishuk: posts big blind 30

\r\n*** HOLE CARDS ***\r\nDealt to IPray2Buddha [6s Kd]\r\ncameltoe3350: folds\r\nKevin2049: folds\r\nIPray2Buddha: folds\r\nSakura2892: folds\r\nLillien66: folds\r\n100%tigerfan: folds\r\nowlie45: calls 15\r\nmpolishuk: checks\r\n*** FLOP *** [Js 4h 3d]\r\nowlie45: bets 46\r\nmpolishuk: folds\r\nUncalled bet (46) returned to owlie45\r\nowlie45 collected 92 from pot\r\nowlie45: doesn't show hand\r\n*** SUMMARY ***\r\nTotal pot 92 | Rake 0\r\nBoard [Js 4h 3d]\r\nSeat 1: mpolishuk (big blind) folded on the Flop\r\nSeat 2: cameltoe3350 folded before Flop (didn't bet)\r\nSeat 3: Kevin2049 folded before Flop (didn't bet)\r\nSeat 4: IPray2Buddha folded before Flop (didn't bet)\r\nSeat 5: Sakura2892 folded before Flop (didn't bet)\r\nSeat 7: Lillien66 folded before Flop (didn't bet)\r\nSeat 8: 100%tigerfan (button) folded before Flop (didn't bet)\r\nSeat 9: owlie45 (small blind) collected (92)\r\n\r\n\r\nPokerStars Hand #232702572008: Tournament #3332581238, $9.22+$0.78 USD Hold'em No Limit - Level II (15/30) - 2021/12/31 22:24:19 ET\r\nTable '3332581238 1' 9-max Seat #9 is the button\r\nSeat 1: mpolishuk (1747 in chips)\r\nSeat 2: cameltoe3350 (1463 in chips)\r\nSeat 3: Kevin2049 (1126 in chips)\r\nSeat 4: IPray2Buddha (1654 in chips)\r\nSeat 5: Sakura2892 (1400 in chips)\r\nSeat 7: Lillien66 (2580 in chips)\r\nSeat 8: 100%tigerfan (1368 in chips)\r\nSeat 9: owlie45 (2162 in chips)\r\nmpolishuk: posts the ante 4\r\ncameltoe3350: posts the ante 4\r\nKevin2049: posts the ante 4\r\nIPray2Buddha: posts the ante 4\r\nSakura2892: posts the ante 4\r\nLillien66: posts the ante 4\r\n100%tigerfan: posts the ante 4\r\nowlie45: posts the ante 4\r\nmpolishuk: posts small blind 15\r\ncameltoe3350: posts big blind 30

\r\n*** HOLE CARDS ***\r\nDealt to IPray2Buddha [Kd 2s]\r\nKevin2049: folds\r\nIPray2Buddha: folds\r\nSakura2892: folds\r\nLillien66: raises 60 to 90\r\n100%tigerfan: folds\r\nowlie45: folds\r\nmpolishuk: folds\r\ncameltoe3350: folds\r\nUncalled bet (60) returned to Lillien66\r\nLillien66 collected 107 from pot\r\nLillien66: doesn't show hand\r\n*** SUMMARY ***\r\nTotal pot 107 | Rake 0\r\nSeat 1: mpolishuk (small blind) folded before Flop\r\nSeat 2: cameltoe3350 (big blind) folded before Flop\r\nSeat 3: Kevin2049 folded before Flop (didn't bet)\r\nSeat 4: IPray2Buddha folded before Flop (didn't bet)\r\nSeat 5: Sakura2892 folded before Flop (didn't bet)\r\nSeat 7: Lillien66 collected (107)\r\nSeat 8: 100%tigerfan folded before Flop (didn't bet)\r\nSeat 9: owlie45 (button) folded before Flop (didn't bet)\r\n\r\n\r\nPokerStars Hand #232702577022: Tournament #3332581238, $9.22+$0.78 USD Hold'em No Limit - Level II (15/30) - 2021/12/31 22:24:42 ET\r\nTable '3332581238 1' 9-max Seat #1 is the button\r\nSeat 1: mpolishuk (1728 in chips)\r\nSeat 2: cameltoe3350 (1429 in chips)\r\nSeat 3: Kevin2049 (1122 in chips)\r\nSeat 4: IPray2Buddha (1650 in chips)\r\nSeat 5: Sakura2892 (1396 in chips)\r\nSeat 7: Lillien66 (2653 in chips)\r\nSeat 8: 100%tigerfan (1364 in chips)\r\nSeat 9: owlie45 (2158 in chips)\r\nmpolishuk: posts the ante 4\r\ncameltoe3350: posts the ante 4\r\nKevin2049: posts the ante 4\r\nIPray2Buddha: posts the ante 4\r\nSakura2892: posts the ante 4\r\nLillien66: posts the ante 4\r\n100%tigerfan: posts the ante 4\r\nowlie45: posts the ante 4\r\ncameltoe3350: posts small blind 15\r\nKevin2049: posts big blind 30

\r\n*** HOLE CARDS ***\r\nDealt to IPray2Buddha [6d 5h]\r\nIPray2Buddha: folds\r\nSakura2892: folds\r\nLillien66: folds\r\n100%tigerfan: folds\r\nowlie45: folds\r\nmpolishuk: folds\r\ncameltoe3350: raises 92 to 122\r\nKevin2049: folds\r\nUncalled bet (92) returned to cameltoe3350\r\ncameltoe3350 collected 92 from pot\r\n*** SUMMARY ***\r\nTotal pot 92 | Rake 0\r\nSeat 1: mpolishuk (button) folded before Flop (didn't bet)\r\nSeat 2: cameltoe3350 (small blind) collected (92)\r\nSeat 3: Kevin2049 (big blind) folded before Flop\r\nSeat 4: IPray2Buddha folded before Flop (didn't bet)\r\nSeat 5: Sakura2892 folded before Flop (didn't bet)\r\nSeat 7: Lillien66 folded before Flop (didn't bet)\r\nSeat 8: 100%tigerfan folded before Flop (didn't bet)\r\nSeat 9: owlie45 folded before Flop (didn't bet)\r\n\r\n\r\nPokerStars Hand #232702583894: Tournament #3332581238, $9.22+$0.78 USD Hold'em No Limit - Level II (15/30) - 2021/12/31 22:25:16 ET\r\nTable '3332581238 1' 9-max Seat #2 is the button\r\nSeat 1: mpolishuk (1724 in chips)\r\nSeat 2: cameltoe3350 (1487 in chips)\r\nSeat 3: Kevin2049 (1088 in chips)\r\nSeat 4: IPray2Buddha (1646 in chips)\r\nSeat 5: Sakura2892 (1392 in chips)\r\nSeat 7: Lillien66 (2649 in chips)\r\nSeat 8: 100%tigerfan (1360 in chips)\r\nSeat 9: owlie45 (2154 in chips)\r\nmpolishuk: posts the ante 4\r\ncameltoe3350: posts the ante 4\r\nKevin2049: posts the ante 4\r\nIPray2Buddha: posts the ante 4\r\nSakura2892: posts the ante 4\r\nLillien66: posts the ante 4\r\n100%tigerfan: posts the ante 4\r\nowlie45: posts the ante 4\r\nKevin2049: posts small blind 15\r\nIPray2Buddha: posts big blind 30

\r\n*** HOLE CARDS ***\r\nDealt to IPray2Buddha [7d Qh]\r\nSakura2892: folds\r\nLillien66: folds\r\n100%tigerfan: folds\r\nowlie45: folds\r\nmpolishuk: folds\r\ncameltoe3350: folds\r\nKevin2049: folds\r\nUncalled bet (15) returned to IPray2Buddha\r\nIPray2Buddha collected 62 from pot\r\n*** SUMMARY ***\r\nTotal pot 62 | Rake 0\r\nSeat 1: mpolishuk folded before Flop (didn't bet)\r\nSeat 2: cameltoe3350 (button) folded before Flop (didn't bet)\r\nSeat 3: Kevin2049 (small blind) folded before Flop\r\nSeat 4: IPray2Buddha (big blind) collected (62)\r\nSeat 5: Sakura2892 folded before Flop (didn't bet)\r\nSeat 7: Lillien66 folded before Flop (didn't bet)\r\nSeat 8: 100%tigerfan folded before Flop (didn't bet)\r\nSeat 9: owlie45 folded before Flop (didn't bet)\r\n\r\n\r\nPokerStars Hand #232702587149: Tournament #3332581238, $9.22+$0.78 USD Hold'em No Limit - Level II (15/30) - 2021/12/31 22:25:31 ET\r\nTable '3332581238 1' 9-max Seat #3 is the button\r\nSeat 1: mpolishuk (1720 in chips)\r\nSeat 2: cameltoe3350 (1483 in chips)\r\nSeat 3: Kevin2049 (1069 in chips)\r\nSeat 4: IPray2Buddha (1689 in chips)\r\nSeat 5: Sakura2892 (1388 in chips)\r\nSeat 7: Lillien66 (2645 in chips)\r\nSeat 8: 100%tigerfan (1356 in chips)\r\nSeat 9: owlie45 (2150 in chips)\r\nmpolishuk: posts the ante 4\r\ncameltoe3350: posts the ante 4\r\nKevin2049: posts the ante 4\r\nIPray2Buddha: posts the ante 4\r\nSakura2892: posts the ante 4\r\nLillien66: posts the ante 4\r\n100%tigerfan: posts the ante 4\r\nowlie45: posts the ante 4\r\nIPray2Buddha: posts small blind 15\r\nSakura2892: posts big blind 30

\r\n*** HOLE CARDS ***\r\nDealt to IPray2Buddha [Tc 7d]\r\nLillien66: folds\r\n100%tigerfan: folds\r\nowlie45: folds\r\nmpolishuk: raises 45 to 75\r\ncameltoe3350: folds\r\nKevin2049: calls 75\r\nIPray2Buddha: folds\r\nSakura2892: folds\r\n*** FLOP *** [Qc 8s Jc]\r\nmpolishuk: checks\r\nKevin2049: bets 143\r\nmpolishuk: folds\r\nUncalled bet (143) returned to Kevin2049\r\nKevin2049 collected 227 from pot\r\nKevin2049: doesn't show hand\r\n*** SUMMARY ***\r\nTotal pot 227 | Rake 0\r\nBoard [Qc 8s Jc]\r\nSeat 1: mpolishuk folded on the Flop\r\nSeat 2: cameltoe3350 folded before Flop (didn't bet)\r\nSeat 3: Kevin2049 (button) collected (227)\r\nSeat 4: IPray2Buddha (small blind) folded before Flop\r\nSeat 5: Sakura2892 (big blind) folded before Flop\r\nSeat 7: Lillien66 folded before Flop (didn't bet)\r\nSeat 8: 100%tigerfan folded before Flop (didn't bet)\r\nSeat 9: owlie45 folded before Flop (didn't bet)\r\n\r\n\r\nPokerStars Hand #232702596156: Tournament #3332581238, $9.22+$0.78 USD Hold'em No Limit - Level II (15/30) - 2021/12/31 22:26:14 ET\r\nTable '3332581238 1' 9-max Seat #4 is the button\r\nSeat 1: mpolishuk (1641 in chips)\r\nSeat 2: cameltoe3350 (1479 in chips)\r\nSeat 3: Kevin2049 (1217 in chips)\r\nSeat 4: IPray2Buddha (1670 in chips)\r\nSeat 5: Sakura2892 (1354 in chips)\r\nSeat 7: Lillien66 (2641 in chips)\r\nSeat 8: 100%tigerfan (1352 in chips)\r\nSeat 9: owlie45 (2146 in chips)\r\nmpolishuk: posts the ante 4\r\ncameltoe3350: posts the ante 4\r\nKevin2049: posts the ante 4\r\nIPray2Buddha: posts the ante 4\r\nSakura2892: posts the ante 4\r\nLillien66: posts the ante 4\r\n100%tigerfan: posts the ante 4\r\nowlie45: posts the ante 4\r\nSakura2892: posts small blind 15\r\nLillien66: posts big blind 30

\r\n*** HOLE CARDS ***\r\nDealt to IPray2Buddha [4d 7h]\r\n100%tigerfan: calls 30\r\nowlie45: raises 120 to 150\r\nmpolishuk: folds\r\ncameltoe3350: folds\r\nKevin2049: folds\r\nIPray2Buddha: folds\r\nSakura2892: folds\r\nLillien66: folds\r\n100%tigerfan: calls 120\r\n*** FLOP *** [2c 8c Qs]\r\n100%tigerfan: bets 60\r\nowlie45: raises 240 to 300\r\n100%tigerfan: raises 898 to 1198 and is all-in\r\nowlie45: calls 898\r\n*** TURN *** [2c 8c Qs] [8d]\r\n*** RIVER *** [2c 8c Qs 8d] [3h]\r\n*** SHOW DOWN ***\r\n100%tigerfan: shows [Jh Qc] (two pair, Queens and Eights)\r\nowlie45: shows [Kh Ks] (two pair, Kings and Eights)\r\nowlie45 collected 2773 from pot\r\n100%tigerfan finished the tournament in 16th place\r\n*** SUMMARY ***\r\nTotal pot 2773 | Rake 0\r\nBoard [2c 8c Qs 8d 3h]\r\nSeat 1: mpolishuk folded before Flop (didn't bet)\r\nSeat 2: cameltoe3350 folded before Flop (didn't bet)\r\nSeat 3: Kevin2049 folded before Flop (didn't bet)\r\nSeat 4: IPray2Buddha (button) folded before Flop (didn't bet)\r\nSeat 5: Sakura2892 (small blind) folded before Flop\r\nSeat 7: Lillien66 (big blind) folded before Flop\r\nSeat 8: 100%tigerfan showed [Jh Qc] and lost with two pair, Queens and Eights\r\nSeat 9: owlie45 showed [Kh Ks] and won (2773) with two pair, Kings and Eights\r\n\r\n\r\nPokerStars Hand #232702615205: Tournament #3332581238, $9.22+$0.78 USD Hold'em No Limit - Level III (25/50) - 2021/12/31 22:27:07 ET\r\nTable '3332581238 1' 9-max Seat #5 is the button\r\nSeat 1: mpolishuk (1637 in chips)\r\nSeat 2: cameltoe3350 (1475 in chips)\r\nSeat 3: Kevin2049 (1213 in chips)\r\nSeat 4: IPray2Buddha (1666 in chips)\r\nSeat 5: Sakura2892 (1335 in chips)\r\nSeat 7: Lillien66 (2607 in chips)\r\nSeat 9: owlie45 (3567 in chips)\r\nmpolishuk: posts the ante 6\r\ncameltoe3350: posts the ante 6\r\nKevin2049: posts the ante 6\r\nIPray2Buddha: posts the ante 6\r\nSakura2892: posts the ante 6\r\nLillien66: posts the ante 6\r\nowlie45: posts the ante 6\r\nLillien66: posts small blind 25\r\nowlie45: posts big blind 50

\r\n*** HOLE CARDS ***\r\nDealt to IPray2Buddha [4h 2s]\r\nmpolishuk: folds\r\ncameltoe3350: folds\r\nKevin2049: raises 50 to 100\r\nIPray2Buddha: folds\r\nSakura2892: folds\r\nLillien66: calls 75\r\nowlie45: calls 50\r\n*** FLOP *** [Ah 8c 8s]\r\nLillien66: checks\r\nowlie45: bets 113\r\nKevin2049: folds\r\nLillien66: folds\r\nUncalled bet (113) returned to owlie45\r\nowlie45 collected 342 from pot\r\nowlie45: doesn't show hand\r\n*** SUMMARY ***\r\nTotal pot 342 | Rake 0\r\nBoard [Ah 8c 8s]\r\nSeat 1: mpolishuk folded before Flop (didn't bet)\r\nSeat 2: cameltoe3350 folded before Flop (didn't bet)\r\nSeat 3: Kevin2049 folded on the Flop\r\nSeat 4: IPray2Buddha folded before Flop (didn't bet)\r\nSeat 5: Sakura2892 (button) folded before Flop (didn't bet)\r\nSeat 7: Lillien66 (small blind) folded on the Flop\r\nSeat 9: owlie45 (big blind) collected (342)\r\n\r\n\r\nPokerStars Hand #232702622128: Tournament #3332581238, $9.22+$0.78 USD Hold'em No Limit - Level III (25/50) - 2021/12/31 22:27:40 ET\r\nTable '3332581238 1' 9-max Seat #7 is the button\r\nSeat 1: mpolishuk (1631 in chips)\r\nSeat 2: cameltoe3350 (1469 in chips)\r\nSeat 3: Kevin2049 (1107 in chips)\r\nSeat 4: IPray2Buddha (1660 in chips)\r\nSeat 5: Sakura2892 (1329 in chips)\r\nSeat 7: Lillien66 (2501 in chips)\r\nSeat 9: owlie45 (3803 in chips)\r\nmpolishuk: posts the ante 6\r\ncameltoe3350: posts the ante 6\r\nKevin2049: posts the ante 6\r\nIPray2Buddha: posts the ante 6\r\nSakura2892: posts the ante 6\r\nLillien66: posts the ante 6\r\nowlie45: posts the ante 6\r\nowlie45: posts small blind 25\r\nmpolishuk: posts big blind 50

\r\n*** HOLE CARDS ***\r\nDealt to IPray2Buddha [Ac Ks]\r\ncameltoe3350: folds\r\nKevin2049: folds\r\nIPray2Buddha: raises 55 to 105\r\nSakura2892: folds\r\nLillien66: folds\r\nowlie45: folds\r\nmpolishuk: folds\r\nUncalled bet (55) returned to IPray2Buddha\r\nIPray2Buddha collected 167 from pot\r\n*** SUMMARY ***\r\nTotal pot 167 | Rake 0\r\nSeat 1: mpolishuk (big blind) folded before Flop\r\nSeat 2: cameltoe3350 folded before Flop (didn't bet)\r\nSeat 3: Kevin2049 folded before Flop (didn't bet)\r\nSeat 4: IPray2Buddha collected (167)\r\nSeat 5: Sakura2892 folded before Flop (didn't bet)\r\nSeat 7: Lillien66 (button) folded before Flop (didn't bet)\r\nSeat 9: owlie45 (small blind) folded before Flop\r\n\r\n\r\nPokerStars Hand #232702626699: Tournament #3332581238, $9.22+$0.78 USD Hold'em No Limit - Level III (25/50) - 2021/12/31 22:28:02 ET\r\nTable '3332581238 1' 9-max Seat #9 is the button\r\nSeat 1: mpolishuk (1575 in chips)\r\nSeat 2: cameltoe3350 (1463 in chips)\r\nSeat 3: Kevin2049 (1101 in chips)\r\nSeat 4: IPray2Buddha (1771 in chips)\r\nSeat 5: Sakura2892 (1323 in chips)\r\nSeat 7: Lillien66 (2495 in chips)\r\nSeat 9: owlie45 (3772 in chips)\r\nmpolishuk: posts the ante 6\r\ncameltoe3350: posts the ante 6\r\nKevin2049: posts the ante 6\r\nIPray2Buddha: posts the ante 6\r\nSakura2892: posts the ante 6\r\nLillien66: posts the ante 6\r\nowlie45: posts the ante 6\r\nmpolishuk: posts small blind 25\r\ncameltoe3350: posts big blind 50

\r\n*** HOLE CARDS ***\r\nDealt to IPray2Buddha [9d 2s]\r\nKevin2049: folds\r\nIPray2Buddha: folds\r\nSakura2892: folds\r\nLillien66: folds\r\nowlie45: folds\r\nmpolishuk: calls 25\r\ncameltoe3350: checks\r\n*** FLOP *** [2c 5s 8d]\r\nmpolishuk: bets 70\r\ncameltoe3350: calls 70\r\n*** TURN *** [2c 5s 8d] [Js]\r\nmpolishuk: bets 135\r\ncameltoe3350: calls 135\r\n*** RIVER *** [2c 5s 8d Js] [Qd]\r\nmpolishuk: checks\r\ncameltoe3350: checks\r\n*** SHOW DOWN ***\r\nmpolishuk: shows [8c 9h] (a pair of Eights)\r\n\r\nmpolishuk collected 552 from pot\r\n*** SUMMARY ***\r\nTotal pot 552 | Rake 0\r\nBoard [2c 5s 8d Js Qd]\r\nSeat 1: mpolishuk (small blind) showed [8c 9h] and won (552) with a pair of Eights\r\nSeat 2: cameltoe3350 (big blind) mucked [5c 3h]\r\nSeat 3: Kevin2049 folded before Flop (didn't bet)\r\nSeat 4: IPray2Buddha folded before Flop (didn't bet)\r\nSeat 5: Sakura2892 folded before Flop (didn't bet)\r\nSeat 7: Lillien66 folded before Flop (didn't bet)\r\nSeat 9: owlie45 (button) folded before Flop (didn't bet)\r\n\r\n\r\nPokerStars Hand #232702639779: Tournament #3332581238, $9.22+$0.78 USD Hold'em No Limit - Level III (25/50) - 2021/12/31 22:29:05 ET\r\nTable '3332581238 1' 9-max Seat #1 is the button\r\nSeat 1: mpolishuk (1866 in chips)\r\nSeat 2: cameltoe3350 (1202 in chips)\r\nSeat 3: Kevin2049 (1095 in chips)\r\nSeat 4: IPray2Buddha (1765 in chips)\r\nSeat 5: Sakura2892 (1317 in chips)\r\nSeat 7: Lillien66 (2489 in chips)\r\nSeat 9: owlie45 (3766 in chips)\r\nmpolishuk: posts the ante 6\r\ncameltoe3350: posts the ante 6\r\nKevin2049: posts the ante 6\r\nIPray2Buddha: posts the ante 6\r\nSakura2892: posts the ante 6\r\nLillien66: posts the ante 6\r\nowlie45: posts the ante 6\r\ncameltoe3350: posts small blind 25\r\nKevin2049: posts big blind 50

\r\n*** HOLE CARDS ***\r\nDealt to IPray2Buddha [5h 3d]\r\nIPray2Buddha: folds\r\nSakura2892: folds\r\nLillien66: folds\r\nowlie45: folds\r\nmpolishuk: folds\r\ncameltoe3350: calls 25\r\nKevin2049: raises 142 to 192\r\ncameltoe3350: folds\r\nUncalled bet (142) returned to Kevin2049\r\nKevin2049 collected 142 from pot\r\nKevin2049: doesn't show hand\r\n*** SUMMARY ***\r\nTotal pot 142 | Rake 0\r\nSeat 1: mpolishuk (button) folded before Flop (didn't bet)\r\nSeat 2: cameltoe3350 (small blind) folded before Flop\r\nSeat 3: Kevin2049 (big blind) collected (142)\r\nSeat 4: IPray2Buddha folded before Flop (didn't bet)\r\nSeat 5: Sakura2892 folded before Flop (didn't bet)\r\nSeat 7: Lillien66 folded before Flop (didn't bet)\r\nSeat 9: owlie45 folded before Flop (didn't bet)\r\n\r\n\r\nPokerStars Hand #232702644272: Tournament #3332581238, $9.22+$0.78 USD Hold'em No Limit - Level III (25/50) - 2021/12/31 22:29:27 ET\r\nTable '3332581238 1' 9-max Seat #2 is the button\r\nSeat 1: mpolishuk (1860 in chips)\r\nSeat 2: cameltoe3350 (1146 in chips)\r\nSeat 3: Kevin2049 (1181 in chips)\r\nSeat 4: IPray2Buddha (1759 in chips)\r\nSeat 5: Sakura2892 (1311 in chips)\r\nSeat 7: Lillien66 (2483 in chips)\r\nSeat 9: owlie45 (3760 in chips)\r\nmpolishuk: posts the ante 6\r\ncameltoe3350: posts the ante 6\r\nKevin2049: posts the ante 6\r\nIPray2Buddha: posts the ante 6\r\nSakura2892: posts the ante 6\r\nLillien66: posts the ante 6\r\nowlie45: posts the ante 6\r\nKevin2049: posts small blind 25\r\nIPray2Buddha: posts big blind 50

\r\n*** HOLE CARDS ***\r\nDealt to IPray2Buddha [6s 3d]\r\nSakura2892: folds\r\nLillien66: folds\r\nowlie45: raises 57 to 107\r\nmpolishuk: folds\r\ncameltoe3350: raises 93 to 200\r\nKevin2049: folds\r\nIPray2Buddha: folds\r\nowlie45: calls 93\r\n*** FLOP *** [Ad 6c Tc]\r\nowlie45: checks\r\ncameltoe3350: bets 200\r\nowlie45: raises 3354 to 3554 and is all-in\r\ncameltoe3350: calls 740 and is all-in\r\nUncalled bet (2614) returned to owlie45\r\n*** TURN *** [Ad 6c Tc] [4h]\r\n*** RIVER *** [Ad 6c Tc 4h] [Js]\r\n*** SHOW DOWN ***\r\nowlie45: shows [3s As] (a pair of Aces)\r\ncameltoe3350: shows [Ks Kh] (a pair of Kings)\r\nowlie45 collected 2397 from pot\r\ncameltoe3350 finished the tournament in 15th place\r\n*** SUMMARY ***\r\nTotal pot 2397 | Rake 0\r\nBoard [Ad 6c Tc 4h Js]\r\nSeat 1: mpolishuk folded before Flop (didn't bet)\r\nSeat 2: cameltoe3350 (button) showed [Ks Kh] and lost with a pair of Kings\r\nSeat 3: Kevin2049 (small blind) folded before Flop\r\nSeat 4: IPray2Buddha (big blind) folded before Flop\r\nSeat 5: Sakura2892 folded before Flop (didn't bet)\r\nSeat 7: Lillien66 folded before Flop (didn't bet)\r\nSeat 9: owlie45 showed [3s As] and won (2397) with a pair of Aces\r\n\r\n\r\nPokerStars Hand #232702660648: Tournament #3332581238, $9.22+$0.78 USD Hold'em No Limit - Level III (25/50) - 2021/12/31 22:30:44 ET\r\nTable '3332581238 1' 9-max Seat #3 is the button\r\nSeat 1: mpolishuk (1854 in chips)\r\nSeat 3: Kevin2049 (1150 in chips)\r\nSeat 4: IPray2Buddha (1703 in chips)\r\nSeat 5: Sakura2892 (1305 in chips)\r\nSeat 7: Lillien66 (2477 in chips)\r\nSeat 9: owlie45 (5011 in chips)\r\nmpolishuk: posts the ante 6\r\nKevin2049: posts the ante 6\r\nIPray2Buddha: posts the ante 6\r\nSakura2892: posts the ante 6\r\nLillien66: posts the ante 6\r\nowlie45: posts the ante 6\r\nIPray2Buddha: posts small blind 25\r\nSakura2892: posts big blind 50

\r\n*** HOLE CARDS ***\r\nDealt to IPray2Buddha [2h Ah]\r\nLillien66: folds\r\nowlie45: raises 57 to 107\r\nmpolishuk: folds\r\nKevin2049: folds\r\nIPray2Buddha: calls 82\r\nSakura2892: folds\r\n*** FLOP *** [Qc 8s 2d]\r\nIPray2Buddha: checks\r\nowlie45: checks\r\n*** TURN *** [Qc 8s 2d] [3s]\r\nIPray2Buddha: bets 90\r\nowlie45: calls 90\r\n*** RIVER *** [Qc 8s 2d 3s] [5c]\r\nIPray2Buddha: checks\r\nowlie45: bets 700\r\nIPray2Buddha: calls 700\r\n*** SHOW DOWN ***\r\nowlie45: shows [5h 5s] (three of a kind, Fives)\r\n\r\nowlie45 collected 1880 from pot\r\n*** SUMMARY ***\r\nTotal pot 1880 | Rake 0\r\nBoard [Qc 8s 2d 3s 5c]\r\nSeat 1: mpolishuk folded before Flop (didn't bet)\r\nSeat 3: Kevin2049 (button) folded before Flop (didn't bet)\r\nSeat 4: IPray2Buddha (small blind) mucked [2h Ah]\r\nSeat 5: Sakura2892 (big blind) folded before Flop\r\nSeat 7: Lillien66 folded before Flop (didn't bet)\r\nSeat 9: owlie45 showed [5h 5s] and won (1880) with three of a kind, Fives\r\n\r\n\r\nPokerStars Hand #232702683661: Tournament #3332581238, $9.22+$0.78 USD Hold'em No Limit - Level IV (40/80) - 2021/12/31 22:32:07 ET\r\nTable '3332581238 1' 9-max Seat #4 is the button\r\nSeat 1: mpolishuk (1848 in chips)\r\nSeat 3: Kevin2049 (1144 in chips)\r\nSeat 4: IPray2Buddha (800 in chips)\r\nSeat 5: Sakura2892 (1249 in chips)\r\nSeat 7: Lillien66 (2471 in chips)\r\nSeat 9: owlie45 (5988 in chips)\r\nmpolishuk: posts the ante 10\r\nKevin2049: posts the ante 10\r\nIPray2Buddha: posts the ante 10\r\nSakura2892: posts the ante 10\r\nLillien66: posts the ante 10\r\nowlie45: posts the ante 10\r\nSakura2892: posts small blind 40\r\nLillien66: posts big blind 80

\r\n*** HOLE CARDS ***\r\nDealt to IPray2Buddha [6h 8s]\r\nowlie45: folds\r\nmpolishuk: folds\r\nKevin2049: folds\r\nIPray2Buddha: folds\r\nSakura2892: calls 40\r\nLillien66: checks\r\n*** FLOP *** [5h 2s 4s]\r\nSakura2892: checks\r\nLillien66: bets 160\r\nSakura2892: raises 383 to 543\r\nLillien66: folds\r\nUncalled bet (383) returned to Sakura2892\r\nSakura2892 collected 540 from pot\r\n*** SUMMARY ***\r\nTotal pot 540 | Rake 0\r\nBoard [5h 2s 4s]\r\nSeat 1: mpolishuk folded before Flop (didn't bet)\r\nSeat 3: Kevin2049 folded before Flop (didn't bet)\r\nSeat 4: IPray2Buddha (button) folded before Flop (didn't bet)\r\nSeat 5: Sakura2892 (small blind) collected (540)\r\nSeat 7: Lillien66 (big blind) folded on the Flop\r\nSeat 9: owlie45 folded before Flop (didn't bet)\r\n\r\n\r\nPokerStars Hand #232702693961: Tournament #3332581238, $9.22+$0.78 USD Hold'em No Limit - Level IV (40/80) - 2021/12/31 22:32:57 ET\r\nTable '3332581238 1' 9-max Seat #5 is the button\r\nSeat 1: mpolishuk (1838 in chips)\r\nSeat 3: Kevin2049 (1134 in chips)\r\nSeat 4: IPray2Buddha (790 in chips)\r\nSeat 5: Sakura2892 (1539 in chips)\r\nSeat 7: Lillien66 (2221 in chips)\r\nSeat 9: owlie45 (5978 in chips)\r\nmpolishuk: posts the ante 10\r\nKevin2049: posts the ante 10\r\nIPray2Buddha: posts the ante 10\r\nSakura2892: posts the ante 10\r\nLillien66: posts the ante 10\r\nowlie45: posts the ante 10\r\nLillien66: posts small blind 40\r\nowlie45: posts big blind 80

\r\n*** HOLE CARDS ***\r\nDealt to IPray2Buddha [As 6c]\r\nmpolishuk: folds\r\nKevin2049: raises 80 to 160\r\nIPray2Buddha: folds\r\nSakura2892: folds\r\nLillien66: folds\r\nowlie45: folds\r\nUncalled bet (80) returned to Kevin2049\r\nKevin2049 collected 260 from pot\r\nKevin2049: doesn't show hand\r\n*** SUMMARY ***\r\nTotal pot 260 | Rake 0\r\nSeat 1: mpolishuk folded before Flop (didn't bet)\r\nSeat 3: Kevin2049 collected (260)\r\nSeat 4: IPray2Buddha folded before Flop (didn't bet)\r\nSeat 5: Sakura2892 (button) folded before Flop (didn't bet)\r\nSeat 7: Lillien66 (small blind) folded before Flop\r\nSeat 9: owlie45 (big blind) folded before Flop\r\n\r\n\r\nPokerStars Hand #232702698178: Tournament #3332581238, $9.22+$0.78 USD Hold'em No Limit - Level IV (40/80) - 2021/12/31 22:33:17 ET\r\nTable '3332581238 1' 9-max Seat #7 is the button\r\nSeat 1: mpolishuk (1828 in chips)\r\nSeat 3: Kevin2049 (1304 in chips)\r\nSeat 4: IPray2Buddha (780 in chips)\r\nSeat 5: Sakura2892 (1529 in chips)\r\nSeat 7: Lillien66 (2171 in chips)\r\nSeat 9: owlie45 (5888 in chips)\r\nmpolishuk: posts the ante 10\r\nKevin2049: posts the ante 10\r\nIPray2Buddha: posts the ante 10\r\nSakura2892: posts the ante 10\r\nLillien66: posts the ante 10\r\nowlie45: posts the ante 10\r\nowlie45: posts small blind 40\r\nmpolishuk: posts big blind 80

\r\n*** HOLE CARDS ***\r\nDealt to IPray2Buddha [5s 5c]\r\nKevin2049: folds\r\nIPray2Buddha: raises 690 to 770 and is all-in\r\nSakura2892: folds\r\nLillien66: folds\r\nowlie45: folds\r\nmpolishuk: folds\r\nUncalled bet (690) returned to IPray2Buddha\r\nIPray2Buddha collected 260 from pot\r\n*** SUMMARY ***\r\nTotal pot 260 | Rake 0\r\nSeat 1: mpolishuk (big blind) folded before Flop\r\nSeat 3: Kevin2049 folded before Flop (didn't bet)\r\nSeat 4: IPray2Buddha collected (260)\r\nSeat 5: Sakura2892 folded before Flop (didn't bet)\r\nSeat 7: Lillien66 (button) folded before Flop (didn't bet)\r\nSeat 9: owlie45 (small blind) folded before Flop\r\n\r\n\r\nPokerStars Hand #232702702841: Tournament #3332581238, $9.22+$0.78 USD Hold'em No Limit - Level IV (40/80) - 2021/12/31 22:33:40 ET\r\nTable '3332581238 1' 9-max Seat #9 is the button\r\nSeat 1: mpolishuk (1738 in chips)\r\nSeat 3: Kevin2049 (1294 in chips)\r\nSeat 4: IPray2Buddha (950 in chips)\r\nSeat 5: Sakura2892 (1519 in chips)\r\nSeat 7: Lillien66 (2161 in chips)\r\nSeat 9: owlie45 (5838 in chips)\r\nmpolishuk: posts the ante 10\r\nKevin2049: posts the ante 10\r\nIPray2Buddha: posts the ante 10\r\nSakura2892: posts the ante 10\r\nLillien66: posts the ante 10\r\nowlie45: posts the ante 10\r\nmpolishuk: posts small blind 40\r\nKevin2049: posts big blind 80

\r\n*** HOLE CARDS ***\r\nDealt to IPray2Buddha [Ad Qh]\r\nIPray2Buddha: raises 860 to 940 and is all-in\r\nSakura2892: folds\r\nLillien66: folds\r\nowlie45: folds\r\nmpolishuk: folds\r\nKevin2049: folds\r\nUncalled bet (860) returned to IPray2Buddha\r\nIPray2Buddha collected 260 from pot\r\n*** SUMMARY ***\r\nTotal pot 260 | Rake 0\r\nSeat 1: mpolishuk (small blind) folded before Flop\r\nSeat 3: Kevin2049 (big blind) folded before Flop\r\nSeat 4: IPray2Buddha collected (260)\r\nSeat 5: Sakura2892 folded before Flop (didn't bet)\r\nSeat 7: Lillien66 folded before Flop (didn't bet)\r\nSeat 9: owlie45 (button) folded before Flop (didn't bet)\r\n\r\n\r\nPokerStars Hand #232702705660: Tournament #3332581238, $9.22+$0.78 USD Hold'em No Limit - Level IV (40/80) - 2021/12/31 22:33:54 ET\r\nTable '3332581238 1' 9-max Seat #1 is the button\r\nSeat 1: mpolishuk (1688 in chips)\r\nSeat 3: Kevin2049 (1204 in chips)\r\nSeat 4: IPray2Buddha (1120 in chips)\r\nSeat 5: Sakura2892 (1509 in chips)\r\nSeat 7: Lillien66 (2151 in chips)\r\nSeat 9: owlie45 (5828 in chips)\r\nmpolishuk: posts the ante 10\r\nKevin2049: posts the ante 10\r\nIPray2Buddha: posts the ante 10\r\nSakura2892: posts the ante 10\r\nLillien66: posts the ante 10\r\nowlie45: posts the ante 10\r\nKevin2049: posts small blind 40\r\nIPray2Buddha: posts big blind 80

\r\n*** HOLE CARDS ***\r\nDealt to IPray2Buddha [7c Ad]\r\nSakura2892: folds\r\nLillien66: folds\r\nowlie45: raises 80 to 160\r\nmpolishuk: raises 340 to 500\r\nKevin2049: folds\r\nIPray2Buddha: folds\r\nowlie45: folds\r\nUncalled bet (340) returned to mpolishuk\r\nmpolishuk collected 500 from pot\r\nmpolishuk: doesn't show hand\r\n*** SUMMARY ***\r\nTotal pot 500 | Rake 0\r\nSeat 1: mpolishuk (button) collected (500)\r\nSeat 3: Kevin2049 (small blind) folded before Flop\r\nSeat 4: IPray2Buddha (big blind) folded before Flop\r\nSeat 5: Sakura2892 folded before Flop (didn't bet)\r\nSeat 7: Lillien66 folded before Flop (didn't bet)\r\nSeat 9: owlie45 folded before Flop\r\n\r\n\r\nPokerStars Hand #232702710836: Tournament #3332581238, $9.22+$0.78 USD Hold'em No Limit - Level IV (40/80) - 2021/12/31 22:34:19 ET\r\nTable '3332581238 1' 9-max Seat #3 is the button\r\nSeat 1: mpolishuk (2018 in chips)\r\nSeat 3: Kevin2049 (1154 in chips)\r\nSeat 4: IPray2Buddha (1030 in chips)\r\nSeat 5: Sakura2892 (1499 in chips)\r\nSeat 7: Lillien66 (2141 in chips)\r\nSeat 9: owlie45 (5658 in chips)\r\nmpolishuk: posts the ante 10\r\nKevin2049: posts the ante 10\r\nIPray2Buddha: posts the ante 10\r\nSakura2892: posts the ante 10\r\nLillien66: posts the ante 10\r\nowlie45: posts the ante 10\r\nIPray2Buddha: posts small blind 40\r\nSakura2892: posts big blind 80

\r\n*** HOLE CARDS ***\r\nDealt to IPray2Buddha [6c 6h]\r\nLillien66: folds\r\nowlie45: folds\r\nmpolishuk: folds\r\nKevin2049: folds\r\nIPray2Buddha: calls 40\r\nSakura2892: raises 1409 to 1489 and is all-in\r\nIPray2Buddha: calls 940 and is all-in\r\nUncalled bet (469) returned to Sakura2892\r\n*** FLOP *** [8d 7c Ts]\r\n*** TURN *** [8d 7c Ts] [6s]\r\n*** RIVER *** [8d 7c Ts 6s] [Ah]\r\n*** SHOW DOWN ***\r\nIPray2Buddha: shows [6c 6h] (three of a kind, Sixes)\r\nSakura2892: shows [Kd Qh] (high card Ace)\r\nIPray2Buddha collected 2100 from pot\r\n*** SUMMARY ***\r\nTotal pot 2100 | Rake 0\r\nBoard [8d 7c Ts 6s Ah]\r\nSeat 1: mpolishuk folded before Flop (didn't bet)\r\nSeat 3: Kevin2049 (button) folded before Flop (didn't bet)\r\nSeat 4: IPray2Buddha (small blind) showed [6c 6h] and won (2100) with three of a kind, Sixes\r\nSeat 5: Sakura2892 (big blind) showed [Kd Qh] and lost with high card Ace\r\nSeat 7: Lillien66 folded before Flop (didn't bet)\r\nSeat 9: owlie45 folded before Flop (didn't bet)\r\n\r\n\r\nPokerStars Hand #232702717457: Tournament #3332581238, $9.22+$0.78 USD Hold'em No Limit - Level IV (40/80) - 2021/12/31 22:34:51 ET\r\nTable '3332581238 1' 9-max Seat #4 is the button\r\nSeat 1: mpolishuk (2008 in chips)\r\nSeat 3: Kevin2049 (1144 in chips)\r\nSeat 4: IPray2Buddha (2100 in chips)\r\nSeat 5: Sakura2892 (469 in chips)\r\nSeat 7: Lillien66 (2131 in chips)\r\nSeat 9: owlie45 (5648 in chips)\r\nmpolishuk: posts the ante 10\r\nKevin2049: posts the ante 10\r\nIPray2Buddha: posts the ante 10\r\nSakura2892: posts the ante 10\r\nLillien66: posts the ante 10\r\nowlie45: posts the ante 10\r\nSakura2892: posts small blind 40\r\nLillien66: posts big blind 80

\r\n*** HOLE CARDS ***\r\nDealt to IPray2Buddha [4c 4h]\r\nowlie45: folds\r\nmpolishuk: folds\r\nKevin2049: raises 80 to 160\r\nIPray2Buddha: folds\r\nSakura2892: folds\r\nLillien66: raises 1961 to 2121 and is all-in\r\nKevin2049: calls 974 and is all-in\r\nUncalled bet (987) returned to Lillien66\r\n*** FLOP *** [8d 2h Qs]\r\n*** TURN *** [8d 2h Qs] [Qc]\r\n*** RIVER *** [8d 2h Qs Qc] [Th]\r\n*** SHOW DOWN ***\r\nLillien66: shows [Tc Ad] (two pair, Queens and Tens)\r\nKevin2049: shows [3c Ac] (a pair of Queens)\r\nLillien66 collected 2368 from pot\r\nKevin2049 finished the tournament in 10th place\r\n*** SUMMARY ***\r\nTotal pot 2368 | Rake 0\r\nBoard [8d 2h Qs Qc Th]\r\nSeat 1: mpolishuk folded before Flop (didn't bet)\r\nSeat 3: Kevin2049 showed [3c Ac] and lost with a pair of Queens\r\nSeat 4: IPray2Buddha (button) folded before Flop (didn't bet)\r\nSeat 5: Sakura2892 (small blind) folded before Flop\r\nSeat 7: Lillien66 (big blind) showed [Tc Ad] and won (2368) with two pair, Queens and Tens\r\nSeat 9: owlie45 folded before Flop (didn't bet)\r\n\r\n\r\n\r\nPokerStars Hand #232702738510: Tournament #3332581238, $9.22+$0.78 USD Hold'em No Limit - Level IV (40/80) - 2021/12/31 22:36:34 ET\r\nTable '3332581238 2' 9-max Seat #5 is the button\r\nSeat 1: Sakura2892 (938 in chips)\r\nSeat 2: chuckie247 (2488 in chips)\r\nSeat 3: w.gator900 (8156 in chips)\r\nSeat 4: Lillien66 (3355 in chips)\r\nSeat 5: papajoe179 (1466 in chips)\r\nSeat 6: x_Jaures_x (901 in chips)\r\nSeat 7: IPray2Buddha (2080 in chips)\r\nSeat 8: mpolishuk (1988 in chips)\r\nSeat 9: owlie45 (5628 in chips)\r\nSakura2892: posts the ante 10\r\nchuckie247: posts the ante 10\r\nw.gator900: posts the ante 10\r\nLillien66: posts the ante 10\r\npapajoe179: posts the ante 10\r\nx_Jaures_x: posts the ante 10\r\nIPray2Buddha: posts the ante 10\r\nmpolishuk: posts the ante 10\r\nowlie45: posts the ante 10\r\nx_Jaures_x: posts small blind 40\r\nIPray2Buddha: posts big blind 80

\r\n*** HOLE CARDS ***\r\nDealt to IPray2Buddha [8c 9c]\r\nmpolishuk: folds\r\nowlie45: raises 80 to 160\r\nSakura2892: folds\r\nchuckie247: folds\r\nw.gator900: calls 160\r\nLillien66: folds\r\npapajoe179: folds\r\nx_Jaures_x: folds\r\nIPray2Buddha: calls 80\r\n*** FLOP *** [Ah Qh 4s]\r\nIPray2Buddha: checks\r\nowlie45: checks\r\nw.gator900: bets 305\r\nIPray2Buddha: folds\r\nowlie45: folds\r\nUncalled bet (305) returned to w.gator900\r\nw.gator900 collected 610 from pot\r\nw.gator900: doesn't show hand\r\n*** SUMMARY ***\r\nTotal pot 610 | Rake 0\r\nBoard [Ah Qh 4s]\r\nSeat 1: Sakura2892 folded before Flop (didn't bet)\r\nSeat 2: chuckie247 folded before Flop (didn't bet)\r\nSeat 3: w.gator900 collected (610)\r\nSeat 4: Lillien66 folded before Flop (didn't bet)\r\nSeat 5: papajoe179 (button) folded before Flop (didn't bet)\r\nSeat 6: x_Jaures_x (small blind) folded before Flop\r\nSeat 7: IPray2Buddha (big blind) folded on the Flop\r\nSeat 8: mpolishuk folded before Flop (didn't bet)\r\nSeat 9: owlie45 folded on the Flop\r\n\r\n\r\nPokerStars Hand #232702747754: Tournament #3332581238, $9.22+$0.78 USD Hold'em No Limit - Level V (60/120) - 2021/12/31 22:37:18 ET\r\nTable '3332581238 2' 9-max Seat #6 is the button\r\nSeat 1: Sakura2892 (928 in chips)\r\nSeat 2: chuckie247 (2478 in chips)\r\nSeat 3: w.gator900 (8596 in chips)\r\nSeat 4: Lillien66 (3345 in chips)\r\nSeat 5: papajoe179 (1456 in chips)\r\nSeat 6: x_Jaures_x (851 in chips)\r\nSeat 7: IPray2Buddha (1910 in chips)\r\nSeat 8: mpolishuk (1978 in chips)\r\nSeat 9: owlie45 (5458 in chips)\r\nSakura2892: posts the ante 15\r\nchuckie247: posts the ante 15\r\nw.gator900: posts the ante 15\r\nLillien66: posts the ante 15\r\npapajoe179: posts the ante 15\r\nx_Jaures_x: posts the ante 15\r\nIPray2Buddha: posts the ante 15\r\nmpolishuk: posts the ante 15\r\nowlie45: posts the ante 15\r\nIPray2Buddha: posts small blind 60\r\nmpolishuk: posts big blind 120


\r\n*** HOLE CARDS ***\r\nDealt to IPray2Buddha [4c Th]\r\nowlie45: folds\r\nSakura2892: folds\r\nchuckie247: folds\r\nw.gator900: raises 120 to 240\r\nLillien66: folds\r\npapajoe179: folds\r\n\r\nx_Jaures_x: folds\r\n\r\nIPray2Buddha: folds\r\nmpolishuk: calls 120\r\n*** FLOP *** [Td Ah 4h]\r\nmpolishuk: checks\r\nw.gator900: bets 338\r\nmpolishuk: calls 338\r\n*** TURN *** [Td Ah 4h] [5s]\r\nmpolishuk: checks\r\nw.gator900: checks\r\n*** RIVER *** [Td Ah 4h 5s] [Kd]\r\nmpolishuk: bets 420\r\nw.gator900: calls 420\r\n*** SHOW DOWN ***\r\nmpolishuk: shows [As 2s] (a pair of Aces)\r\n\r\nmpolishuk collected 2191 from pot\r\n*** SUMMARY ***\r\nTotal pot 2191 | Rake 0\r\nBoard [Td Ah 4h 5s Kd]\r\nSeat 1: Sakura2892 folded before Flop (didn't bet)\r\nSeat 2: chuckie247 folded before Flop (didn't bet)\r\nSeat 3: w.gator900 mucked [Kc Qs]\r\nSeat 4: Lillien66 folded before Flop (didn't bet)\r\nSeat 5: papajoe179 folded before Flop (didn't bet)\r\nSeat 6: x_Jaures_x (button) folded before Flop (didn't bet)\r\nSeat 7: IPray2Buddha (small blind) folded before Flop\r\nSeat 8: mpolishuk (big blind) showed [As 2s] and won (2191) with a pair of Aces\r\nSeat 9: owlie45 folded before Flop (didn't bet)\r\n\r\n\r\n\r\nPokerStars Hand #232702779586: Tournament #3332581238, $9.22+$0.78 USD Hold'em No Limit - Level V (60/120) - 2021/12/31 22:39:50 ET\r\nTable '3332581238 2' 9-max Seat #8 is the button\r\nSeat 1: Sakura2892 (898 in chips)\r\nSeat 2: chuckie247 (2448 in chips)\r\nSeat 3: w.gator900 (7568 in chips)\r\nSeat 4: Lillien66 (3315 in chips)\r\nSeat 5: papajoe179 (1426 in chips)\r\nSeat 6: x_Jaures_x (821 in chips)\r\nSeat 7: IPray2Buddha (1820 in chips)\r\nSeat 8: mpolishuk (3396 in chips)\r\nSeat 9: owlie45 (5308 in chips)\r\nSakura2892: posts the ante 15\r\nchuckie247: posts the ante 15\r\nw.gator900: posts the ante 15\r\nLillien66: posts the ante 15\r\npapajoe179: posts the ante 15\r\nx_Jaures_x: posts the ante 15\r\nIPray2Buddha: posts the ante 15\r\nmpolishuk: posts the ante 15\r\nowlie45: posts the ante 15\r\nowlie45: posts small blind 60\r\nSakura2892: posts big blind 120

\r\n*** HOLE CARDS ***\r\nDealt to IPray2Buddha [Td Qh]\r\nchuckie247: calls 120\r\nw.gator900: folds\r\nLillien66: folds\r\npapajoe179: calls 120\r\nx_Jaures_x: folds\r\nIPray2Buddha: folds\r\nmpolishuk: folds\r\nowlie45: raises 5173 to 5293 and is all-in\r\nSakura2892: folds\r\nchuckie247: folds\r\npapajoe179: folds\r\nUncalled bet (5173) returned to owlie45\r\nowlie45 collected 615 from pot\r\nowlie45: doesn't show hand\r\n*** SUMMARY ***\r\nTotal pot 615 | Rake 0\r\nSeat 1: Sakura2892 (big blind) folded before Flop\r\nSeat 2: chuckie247 folded before Flop\r\nSeat 3: w.gator900 folded before Flop (didn't bet)\r\nSeat 4: Lillien66 folded before Flop (didn't bet)\r\nSeat 5: papajoe179 folded before Flop\r\nSeat 6: x_Jaures_x folded before Flop (didn't bet)\r\nSeat 7: IPray2Buddha folded before Flop (didn't bet)\r\nSeat 8: mpolishuk (button) folded before Flop (didn't bet)\r\nSeat 9: owlie45 (small blind) collected (615)\r\n\r\n\r\n\r\nPokerStars Hand #232702816013: Tournament #3332581238, $9.22+$0.78 USD Hold'em No Limit - Level VI (80/160) - 2021/12/31 22:42:04 ET\r\nTable '3332581238 2' 9-max Seat #1 is the button\r\nSeat 1: Sakura2892 (688 in chips)\r\nSeat 2: chuckie247 (2973 in chips)\r\nSeat 3: w.gator900 (7538 in chips)\r\nSeat 4: Lillien66 (3285 in chips)\r\nSeat 5: papajoe179 (1276 in chips)\r\nSeat 6: x_Jaures_x (791 in chips)\r\nSeat 7: IPray2Buddha (1790 in chips)\r\nSeat 8: mpolishuk (2886 in chips)\r\nSeat 9: owlie45 (5773 in chips)\r\nSakura2892: posts the ante 20\r\nchuckie247: posts the ante 20\r\nw.gator900: posts the ante 20\r\nLillien66: posts the ante 20\r\npapajoe179: posts the ante 20\r\nx_Jaures_x: posts the ante 20\r\nIPray2Buddha: posts the ante 20\r\nmpolishuk: posts the ante 20\r\nowlie45: posts the ante 20\r\nchuckie247: posts small blind 80\r\nw.gator900: posts big blind 160

\r\n*** HOLE CARDS ***\r\nDealt to IPray2Buddha [Ac Kh]\r\nLillien66: folds\r\npapajoe179: calls 160\r\nx_Jaures_x: folds\r\nIPray2Buddha: raises 1610 to 1770 and is all-in\r\nmpolishuk: folds\r\nowlie45: folds\r\nSakura2892: folds\r\nchuckie247: folds\r\nw.gator900: folds\r\npapajoe179: folds\r\nUncalled bet (1610) returned to IPray2Buddha\r\nIPray2Buddha collected 740 from pot\r\n*** SUMMARY ***\r\nTotal pot 740 | Rake 0\r\nSeat 1: Sakura2892 (button) folded before Flop (didn't bet)\r\nSeat 2: chuckie247 (small blind) folded before Flop\r\nSeat 3: w.gator900 (big blind) folded before Flop\r\nSeat 4: Lillien66 folded before Flop (didn't bet)\r\nSeat 5: papajoe179 folded before Flop\r\nSeat 6: x_Jaures_x folded before Flop (didn't bet)\r\nSeat 7: IPray2Buddha collected (740)\r\nSeat 8: mpolishuk folded before Flop (didn't bet)\r\nSeat 9: owlie45 folded before Flop (didn't bet)\r\n\r\n\r\nPokerStars Hand #232702821315: Tournament #3332581238, $9.22+$0.78 USD Hold'em No Limit - Level VI (80/160) - 2021/12/31 22:42:31 ET\r\nTable '3332581238 2' 9-max Seat #2 is the button\r\nSeat 1: Sakura2892 (668 in chips)\r\nSeat 2: chuckie247 (2873 in chips)\r\nSeat 3: w.gator900 (7358 in chips)\r\nSeat 4: Lillien66 (3265 in chips)\r\nSeat 5: papajoe179 (1096 in chips)\r\nSeat 6: x_Jaures_x (771 in chips)\r\nSeat 7: IPray2Buddha (2350 in chips)\r\nSeat 8: mpolishuk (2866 in chips)\r\nSeat 9: owlie45 (5753 in chips)\r\nSakura2892: posts the ante 20\r\nchuckie247: posts the ante 20\r\nw.gator900: posts the ante 20\r\nLillien66: posts the ante 20\r\npapajoe179: posts the ante 20\r\nx_Jaures_x: posts the ante 20\r\nIPray2Buddha: posts the ante 20\r\nmpolishuk: posts the ante 20\r\nowlie45: posts the ante 20\r\nw.gator900: posts small blind 80\r\nLillien66: posts big blind 160

\r\n*** HOLE CARDS ***\r\nDealt to IPray2Buddha [5d 4s]\r\npapajoe179: calls 160\r\nx_Jaures_x: calls 160\r\nIPray2Buddha: folds\r\nmpolishuk: folds\r\nowlie45: folds\r\nSakura2892: folds\r\nchuckie247: folds\r\nw.gator900: folds\r\nLillien66: checks\r\n*** FLOP *** [7d 2c 4d]\r\nLillien66: checks\r\npapajoe179: bets 370\r\nx_Jaures_x: folds\r\nLillien66: folds\r\nUncalled bet (370) returned to papajoe179\r\npapajoe179 collected 740 from pot\r\npapajoe179: doesn't show hand\r\n*** SUMMARY ***\r\nTotal pot 740 | Rake 0\r\nBoard [7d 2c 4d]\r\nSeat 1: Sakura2892 folded before Flop (didn't bet)\r\nSeat 2: chuckie247 (button) folded before Flop (didn't bet)\r\nSeat 3: w.gator900 (small blind) folded before Flop\r\nSeat 4: Lillien66 (big blind) folded on the Flop\r\nSeat 5: papajoe179 collected (740)\r\nSeat 6: x_Jaures_x folded on the Flop\r\nSeat 7: IPray2Buddha folded before Flop (didn't bet)\r\nSeat 8: mpolishuk folded before Flop (didn't bet)\r\nSeat 9: owlie45 folded before Flop (didn't bet)\r\n\r\n\r\nPokerStars Hand #232702830850: Tournament #3332581238, $9.22+$0.78 USD Hold'em No Limit - Level VI (80/160) - 2021/12/31 22:43:19 ET\r\nTable '3332581238 2' 9-max Seat #3 is the button\r\nSeat 1: Sakura2892 (648 in chips)\r\nSeat 2: chuckie247 (2853 in chips)\r\nSeat 3: w.gator900 (7258 in chips)\r\nSeat 4: Lillien66 (3085 in chips)\r\nSeat 5: papajoe179 (1656 in chips)\r\nSeat 6: x_Jaures_x (591 in chips)\r\nSeat 7: IPray2Buddha (2330 in chips)\r\nSeat 8: mpolishuk (2846 in chips)\r\nSeat 9: owlie45 (5733 in chips)\r\nSakura2892: posts the ante 20\r\nchuckie247: posts the ante 20\r\nw.gator900: posts the ante 20\r\nLillien66: posts the ante 20\r\npapajoe179: posts the ante 20\r\nx_Jaures_x: posts the ante 20\r\nIPray2Buddha: posts the ante 20\r\nmpolishuk: posts the ante 20\r\nowlie45: posts the ante 20\r\nLillien66: posts small blind 80\r\npapajoe179: posts big blind 160

\r\n*** HOLE CARDS ***\r\nDealt to IPray2Buddha [3d 5c]\r\nx_Jaures_x: folds\r\nIPray2Buddha: folds\r\nmpolishuk: folds\r\nowlie45: raises 160 to 320\r\nSakura2892: folds\r\nchuckie247: folds\r\nw.gator900: folds\r\nLillien66: folds\r\npapajoe179: calls 160\r\n*** FLOP *** [6s 2h 9d]\r\npapajoe179: checks\r\nowlie45: checks\r\n*** TURN *** [6s 2h 9d] [Ks]\r\npapajoe179: bets 1316 and is all-in\r\nowlie45: folds\r\nUncalled bet (1316) returned to papajoe179\r\npapajoe179 collected 900 from pot\r\npapajoe179: doesn't show hand\r\n*** SUMMARY ***\r\nTotal pot 900 | Rake 0\r\nBoard [6s 2h 9d Ks]\r\nSeat 1: Sakura2892 folded before Flop (didn't bet)\r\nSeat 2: chuckie247 folded before Flop (didn't bet)\r\nSeat 3: w.gator900 (button) folded before Flop (didn't bet)\r\nSeat 4: Lillien66 (small blind) folded before Flop\r\nSeat 5: papajoe179 (big blind) collected (900)\r\nSeat 6: x_Jaures_x folded before Flop (didn't bet)\r\nSeat 7: IPray2Buddha folded before Flop (didn't bet)\r\nSeat 8: mpolishuk folded before Flop (didn't bet)\r\nSeat 9: owlie45 folded on the Turn\r\n\r\n\r\nPokerStars Hand #232702842055: Tournament #3332581238, $9.22+$0.78 USD Hold'em No Limit - Level VI (80/160) - 2021/12/31 22:44:16 ET\r\nTable '3332581238 2' 9-max Seat #4 is the button\r\nSeat 1: Sakura2892 (628 in chips)\r\nSeat 2: chuckie247 (2833 in chips)\r\nSeat 3: w.gator900 (7238 in chips)\r\nSeat 4: Lillien66 (2985 in chips)\r\nSeat 5: papajoe179 (2216 in chips)\r\nSeat 6: x_Jaures_x (571 in chips)\r\nSeat 7: IPray2Buddha (2310 in chips)\r\nSeat 8: mpolishuk (2826 in chips)\r\nSeat 9: owlie45 (5393 in chips)\r\nSakura2892: posts the ante 20\r\nchuckie247: posts the ante 20\r\nw.gator900: posts the ante 20\r\nLillien66: posts the ante 20\r\npapajoe179: posts the ante 20\r\nx_Jaures_x: posts the ante 20\r\nIPray2Buddha: posts the ante 20\r\nmpolishuk: posts the ante 20\r\nowlie45: posts the ante 20\r\npapajoe179: posts small blind 80\r\nx_Jaures_x: posts big blind 160

\r\n*** HOLE CARDS ***\r\nDealt to IPray2Buddha [Jd 6c]\r\nIPray2Buddha: folds\r\nmpolishuk: folds\r\nowlie45: folds\r\nSakura2892: folds\r\nchuckie247: folds\r\nw.gator900: folds\r\nLillien66: raises 2805 to 2965 and is all-in\r\npapajoe179: folds\r\nx_Jaures_x: folds\r\nUncalled bet (2805) returned to Lillien66\r\nLillien66 collected 580 from pot\r\nLillien66: doesn't show hand\r\n*** SUMMARY ***\r\nTotal pot 580 | Rake 0\r\nSeat 1: Sakura2892 folded before Flop (didn't bet)\r\nSeat 2: chuckie247 folded before Flop (didn't bet)\r\nSeat 3: w.gator900 folded before Flop (didn't bet)\r\nSeat 4: Lillien66 (button) collected (580)\r\nSeat 5: papajoe179 (small blind) folded before Flop\r\nSeat 6: x_Jaures_x (big blind) folded before Flop\r\nSeat 7: IPray2Buddha folded before Flop (didn't bet)\r\nSeat 8: mpolishuk folded before Flop (didn't bet)\r\nSeat 9: owlie45 folded before Flop (didn't bet)\r\n\r\n\r\nPokerStars Hand #232702850485: Tournament #3332581238, $9.22+$0.78 USD Hold'em No Limit - Level VI (80/160) - 2021/12/31 22:44:58 ET\r\nTable '3332581238 2' 9-max Seat #5 is the button\r\nSeat 1: Sakura2892 (608 in chips)\r\nSeat 2: chuckie247 (2813 in chips)\r\nSeat 3: w.gator900 (7218 in chips)\r\nSeat 4: Lillien66 (3385 in chips)\r\nSeat 5: papajoe179 (2116 in chips)\r\nSeat 6: x_Jaures_x (391 in chips)\r\nSeat 7: IPray2Buddha (2290 in chips)\r\nSeat 8: mpolishuk (2806 in chips)\r\nSeat 9: owlie45 (5373 in chips)\r\nSakura2892: posts the ante 20\r\nchuckie247: posts the ante 20\r\nw.gator900: posts the ante 20\r\nLillien66: posts the ante 20\r\npapajoe179: posts the ante 20\r\nx_Jaures_x: posts the ante 20\r\nIPray2Buddha: posts the ante 20\r\nmpolishuk: posts the ante 20\r\nowlie45: posts the ante 20\r\nx_Jaures_x: posts small blind 80\r\nIPray2Buddha: posts big blind 160

\r\n*** HOLE CARDS ***\r\nDealt to IPray2Buddha [Ts 6s]\r\nmpolishuk: folds\r\nowlie45: folds\r\nSakura2892: folds\r\nchuckie247: folds\r\nw.gator900: folds\r\nLillien66: folds\r\npapajoe179: calls 160\r\nx_Jaures_x: folds\r\nIPray2Buddha: checks\r\n*** FLOP *** [Td Ah Qs]\r\nIPray2Buddha: checks\r\npapajoe179: bets 580\r\nIPray2Buddha: folds\r\nUncalled bet (580) returned to papajoe179\r\npapajoe179 collected 580 from pot\r\npapajoe179: doesn't show hand\r\n*** SUMMARY ***\r\nTotal pot 580 | Rake 0\r\nBoard [Td Ah Qs]\r\nSeat 1: Sakura2892 folded before Flop (didn't bet)\r\nSeat 2: chuckie247 folded before Flop (didn't bet)\r\nSeat 3: w.gator900 folded before Flop (didn't bet)\r\nSeat 4: Lillien66 folded before Flop (didn't bet)\r\nSeat 5: papajoe179 (button) collected (580)\r\nSeat 6: x_Jaures_x (small blind) folded before Flop\r\nSeat 7: IPray2Buddha (big blind) folded on the Flop\r\nSeat 8: mpolishuk folded before Flop (didn't bet)\r\nSeat 9: owlie45 folded before Flop (didn't bet)\r\n\r\n\r\nPokerStars Hand #232702860417: Tournament #3332581238, $9.22+$0.78 USD Hold'em No Limit - Level VI (80/160) - 2021/12/31 22:45:41 ET\r\nTable '3332581238 2' 9-max Seat #6 is the button\r\nSeat 1: Sakura2892 (588 in chips)\r\nSeat 2: chuckie247 (2793 in chips)\r\nSeat 3: w.gator900 (7198 in chips)\r\nSeat 4: Lillien66 (3365 in chips)\r\nSeat 5: papajoe179 (2516 in chips)\r\nSeat 6: x_Jaures_x (291 in chips)\r\nSeat 7: IPray2Buddha (2110 in chips)\r\nSeat 8: mpolishuk (2786 in chips)\r\nSeat 9: owlie45 (5353 in chips)\r\nSakura2892: posts the ante 20\r\nchuckie247: posts the ante 20\r\nw.gator900: posts the ante 20\r\nLillien66: posts the ante 20\r\npapajoe179: posts the ante 20\r\nx_Jaures_x: posts the ante 20\r\nIPray2Buddha: posts the ante 20\r\nmpolishuk: posts the ante 20\r\nowlie45: posts the ante 20\r\nIPray2Buddha: posts small blind 80\r\nmpolishuk: posts big blind 160

\r\n*** HOLE CARDS ***\r\nDealt to IPray2Buddha [5d 5h]\r\nowlie45: folds\r\nSakura2892: folds\r\nchuckie247: calls 160\r\nw.gator900: folds\r\nLillien66: folds\r\npapajoe179: calls 160\r\nx_Jaures_x: folds\r\nIPray2Buddha: calls 80\r\nmpolishuk: checks\r\n*** FLOP *** [6c 4h 9c]\r\nIPray2Buddha: checks\r\nmpolishuk: bets 400\r\nchuckie247: folds\r\npapajoe179: folds\r\nIPray2Buddha: folds\r\nUncalled bet (400) returned to mpolishuk\r\nmpolishuk collected 820 from pot\r\n*** SUMMARY ***\r\nTotal pot 820 | Rake 0\r\nBoard [6c 4h 9c]\r\nSeat 1: Sakura2892 folded before Flop (didn't bet)\r\nSeat 2: chuckie247 folded on the Flop\r\nSeat 3: w.gator900 folded before Flop (didn't bet)\r\nSeat 4: Lillien66 folded before Flop (didn't bet)\r\nSeat 5: papajoe179 folded on the Flop\r\nSeat 6: x_Jaures_x (button) folded before Flop (didn't bet)\r\nSeat 7: IPray2Buddha (small blind) folded on the Flop\r\nSeat 8: mpolishuk (big blind) collected (820)\r\nSeat 9: owlie45 folded before Flop (didn't bet)\r\n\r\n\r\nPokerStars Hand #232702871282: Tournament #3332581238, $9.22+$0.78 USD Hold'em No Limit - Level VI (80/160) - 2021/12/31 22:46:37 ET\r\nTable '3332581238 2' 9-max Seat #7 is the button\r\nSeat 1: Sakura2892 (568 in chips)\r\nSeat 2: chuckie247 (2613 in chips)\r\nSeat 3: w.gator900 (7178 in chips)\r\nSeat 4: Lillien66 (3345 in chips)\r\nSeat 5: papajoe179 (2336 in chips)\r\nSeat 6: x_Jaures_x (271 in chips)\r\nSeat 7: IPray2Buddha (1930 in chips)\r\nSeat 8: mpolishuk (3426 in chips)\r\nSeat 9: owlie45 (5333 in chips)\r\nSakura2892: posts the ante 20\r\nchuckie247: posts the ante 20\r\nw.gator900: posts the ante 20\r\nLillien66: posts the ante 20\r\npapajoe179: posts the ante 20\r\nx_Jaures_x: posts the ante 20\r\nIPray2Buddha: posts the ante 20\r\nmpolishuk: posts the ante 20\r\nowlie45: posts the ante 20\r\nmpolishuk: posts small blind 80\r\nowlie45: posts big blind 160

\r\n*** HOLE CARDS ***\r\nDealt to IPray2Buddha [9s 4c]\r\nSakura2892: raises 388 to 548 and is all-in\r\nchuckie247: folds\r\nw.gator900: folds\r\nLillien66: folds\r\npapajoe179: folds\r\nx_Jaures_x: folds\r\nIPray2Buddha: folds\r\nmpolishuk: folds\r\nowlie45: calls 388\r\n*** FLOP *** [8s Tc Jh]\r\n*** TURN *** [8s Tc Jh] [Qc]\r\n*** RIVER *** [8s Tc Jh Qc] [Kd]\r\n*** SHOW DOWN ***\r\nowlie45: shows [Ac Qs] (a straight, Ten to Ace)\r\nSakura2892: shows [Ah Td] (a straight, Ten to Ace)\r\nowlie45 collected 678 from pot\r\nSakura2892 collected 678 from pot\r\n*** SUMMARY ***\r\nTotal pot 1356 | Rake 0\r\nBoard [8s Tc Jh Qc Kd]\r\nSeat 1: Sakura2892 showed [Ah Td] and won (678) with a straight, Ten to Ace\r\nSeat 2: chuckie247 folded before Flop (didn't bet)\r\nSeat 3: w.gator900 folded before Flop (didn't bet)\r\nSeat 4: Lillien66 folded before Flop (didn't bet)\r\nSeat 5: papajoe179 folded before Flop (didn't bet)\r\nSeat 6: x_Jaures_x folded before Flop (didn't bet)\r\nSeat 7: IPray2Buddha (button) folded before Flop (didn't bet)\r\nSeat 8: mpolishuk (small blind) folded before Flop\r\nSeat 9: owlie45 (big blind) showed [Ac Qs] and won (678) with a straight, Ten to Ace\r\n\r\n"